,puma,Total_geo,Total_geo_m,Total_geo_f,Total_Avg_PINCP_mf_t,Total_Avg_PINCP_m,Total_Avg_PINCP_f,Total_BABS,Total_BABS_m,Total_BABS_f,BABS_Avg_PINCP_mf_t,BABS_Avg_PINCP_m,BABS_Avg_PINCP_f,Total_HS,Total_HS_m,Total_HS_f,HS_Avg_PINCP_mf_t,HS_Avg_PINCP_m,HS_Avg_PINCP_f,Total_HSINC,Total_HSINC_m,Total_HSINC_f,HSINC_Avg_PINCP_mf_t,HSINC_Avg_PINCP_m,HSINC_Avg_PINCP_f
0,Total Geo,813053,467831,345222,53963.44056414526,55215,52266,328046,174499,153547,78355.07477914683,82784,73321,374035,215761,158274,39519.2248746775,41371,36993,110972,77571,33401,30543.696644198535,31703,27850
1,"NYC-Manhattan Community District 6--Murray Hill, Gramercy & Stuyvesant Town PUMA",5052,1643,3409,165838.45209817894,249721,125410,4554,1643,2911,175733.61001317523,249721,133974,498,0,498,75351.40562248995,0,75351,0,0,0,#DIV/0!,0,0
2,Tompkins County PUMA,1711,944,767,48845.061367621274,69300,23668,1360,593,767,44502.5,71449,23668,351,351,0,65670.94017094017,65670,0,0,0,0,#DIV/0!,0,0
3,Westchester County (South Central)--New Rochelle & Mount Vernon Cities PUMA,9953,5405,4548,50733.627047121474,54823,45873,2676,1245,1431,86628.47533632287,114958,61980,5488,3107,2381,40888.44752186589,39843,42252,1789,1053,736,27243.258803801007,27924,26269
4,"NYC-Queens Community District 7--Flushing, Murray Hill & Whitestone PUMA",29284,16719,12565,52956.109479579296,57979,46272,11523,6597,4926,66957.41386791634,75600,55382,15809,9011,6798,45838.16876462774,48845,41852,1952,1111,841,27951.239754098362,27425,28645
5,Madison & Cortland Counties PUMA,82,39,43,17253.658536585364,3200,30000,0,0,0,#DIV/0!,0,0,82,39,43,17253.658536585364,3200,30000,0,0,0,#DIV/0!,0,0
6,NYC-Brooklyn Community District 5--East New York & Starrett City PUMA,10253,5273,4980,37126.57466107481,39549,34561,1829,646,1183,61384.62001093494,79519,51481,6622,3290,3332,32240.81848384174,34331,30176,1802,1337,465,30459.267480577135,33078,22929
7,Dutchess County (Southwest) PUMA,5362,3133,2229,83824.86758672138,82381,85853,3341,1524,1817,114563.35228973361,136891,95835,1430,1018,412,38345.79020979021,36934,41832,591,591,0,20098.646362098138,20098,0
8,"NYC-Bronx Community District 3 & 6--Belmont, Crotona Park East & East Tremont PUMA",10561,5923,4638,33918.54843291355,32808,35335,2004,708,1296,39762.5748502994,44326,37269,7354,4332,3022,34487.32526516182,33450,35973,1203,883,320,20706.400665004156,20424,21484
9,Dutchess County (North & East) PUMA,2662,1275,1387,43470.788880540946,41669,45126,697,185,512,74375.89670014346,105059,63289,1390,743,647,33390.21582733813,31974,35016,575,347,228,30377.11304347826,28634,33030
10,Erie County (Central) PUMA,908,791,117,52193.711453744494,56888,20452,498,425,73,54562.14859437751,61357,15000,410,366,44,49316.92682926829,51699,29500,0,0,0,#DIV/0!,0,0
11,Suffolk County (West Central)--Babylon Town (Northwest) PUMA,5374,2943,2431,54590.16189058429,53698,55669,1220,187,1033,69447.62295081967,71061,69155,3269,2058,1211,50166.14561027837,52056,46953,885,698,187,50450.056497175145,53887,37620
12,"Otsego, Schoharie, Oneida (South) & Herkimer (South) Counties PUMA",96,57,39,51672.5,43783,63202,64,36,28,49373.4375,52000,45996,19,8,11,83126.31578947368,50300,107000,13,13,0,17020.0,17020,0
13,NYC-Brooklyn Community District 7--Sunset Park & Windsor Terrace PUMA,13553,8411,5142,47590.23242086623,42705,55580,4413,2542,1871,88367.48243825062,72566,109834,6497,3904,2593,28125.7995998153,31609,22880,2643,1965,678,27352.024214907302,26119,30923
14,Westchester County (Northeast) PUMA,5870,2837,3033,56902.11243611584,67950,46567,2728,997,1731,77826.50293255132,121258,52810,1953,651,1302,44052.07373271889,55621,38267,1189,1189,0,30000.84104289319,30000,0
15,Nassau County (East Central)--Oyster Bay Town (Central) PUMA,7148,5166,1982,73429.7006155568,81917,51307,4248,3085,1163,83546.61016949153,90518,65051,1517,983,534,84036.45352669743,112660,31344,1383,1098,285,30720.318148951555,30225,32625
16,Niagara County (Southwest)--Greater Niagara Falls & North Tonawanda Area PUMA,530,228,302,17983.962264150945,11585,22814,18,0,18,17000.0,0,17000,316,184,132,14485.759493670887,4790,28000,196,44,152,23714.285714285714,40000,19000
17,Nassau County (Central)--Hempstead Town (East Central) PUMA,1465,565,900,67763.14675767918,88206,54929,587,317,270,116367.46166950597,102500,132648,358,248,110,57664.804469273746,69935,30000,520,0,520,19848.673076923078,0,19848
18,Niagara County (North & East) PUMA,244,125,119,28491.803278688523,48000,8000,0,0,0,#DIV/0!,0,0,0,0,0,#DIV/0!,0,0,244,125,119,28491.803278688523,48000,8000
19,"NYC-Queens Community District 13--Queens Village, Cambria Heights & Rosedale PUMA",18492,11097,7395,46692.33290071382,46626,46790,6699,3680,3019,60586.53828929691,57586,64243,10425,6447,3978,39867.84652278177,43048,34713,1368,970,398,30660.16081871345,28834,35110
20,"Chenango, Delaware & Broome (East) Counties PUMA",688,383,305,60322.67441860465,42000,83331,605,383,222,66952.06611570247,42000,110000,83,0,83,12000.0,0,12000,0,0,0,#DIV/0!,0,0
21,Oswego County PUMA,423,423,0,33840.59101654846,33840,0,33,33,0,55000.0,55000,0,390,390,0,32050.17948717949,32050,0,0,0,0,#DIV/0!,0,0
22,"NYC-Brooklyn Community District 9--Crown Heights South, Prospect Lefferts & Wingate PUMA",5449,2577,2872,45704.295467058175,33671,56501,1541,288,1253,85639.844256976,40444,96027,2763,1321,1442,30110.861382555195,35096,25543,1145,968,177,29585.498689956334,29710,28900
23,NYC-Queens Community District 10--Howard Beach & Ozone Park PUMA,5953,3751,2202,48416.76801612632,50498,44870,1840,1156,684,70757.34782608696,71726,69120,3465,1999,1466,38801.47186147186,42599,33622,648,596,52,36395.67901234568,35819,43000
24,Ontario & Yates Counties PUMA,795,199,596,20672.830188679247,13275,23142,121,0,121,60363.63636363636,0,60363,674,199,475,13547.3293768546,13275,13661,0,0,0,#DIV/0!,0,0
25,"NYC-Bronx Community District 8--Riverdale, Fieldston & Kingsbridge PUMA",8948,3978,4970,51825.888466696466,49275,53867,4306,1638,2668,63402.77519739898,57285,67158,3672,1892,1780,42898.06644880174,46497,39071,970,448,522,34230.927835051545,31716,36388
26,Erie County (Northwest) PUMA,1136,732,404,28806.8661971831,29323,27871,220,126,94,93127.27272727272,88000,100000,916,606,310,13358.73362445415,17123,6000,0,0,0,#DIV/0!,0,0
27,NYC-Brooklyn Community District 14--Flatbush & Midwood PUMA,10544,6043,4501,49752.73795523521,35313,69138,3356,1328,2028,86125.08015494636,40777,115820,4716,3018,1698,36205.3647158609,36286,36060,2472,1697,775,26218.68932038835,29306,19457
28,"Rockland County (West)--Spring Valley, Suffern Villages & Monsey PUMA",6243,3441,2802,53376.533717763894,60010,45229,1936,1373,563,86792.61363636363,94071,69041,3552,1642,1910,40852.59009009009,39505,42010,755,426,329,26610.331125827815,29271,23164
29,"NYC-Manhattan Community District 1 & 2--Battery Park City, Greenwich Village & Soho PUMA",8099,4146,3953,105577.30584022719,106635,104467,6619,3056,3563,118645.58090345973,130203,108732,448,181,267,103686.38392857143,142005,77709,1032,909,123,22581.39534883721,20359,39000
30,"NYC-Bronx Community District 4--Concourse, Highbridge & Mount Eden PUMA",12768,7126,5642,36573.33302005012,39727,32589,4532,2443,2089,45107.06443071492,45473,44678,6678,3811,2867,32912.5187181791,38008,26138,1558,872,686,27441.142490372273,31146,22731
31,NYC-Queens Community District 1--Astoria & Long Island City PUMA,16414,10949,5465,53733.19970756671,55395,50401,8217,4717,3500,68213.16782280638,73277,61388,6002,4650,1352,38159.60346551149,40202,31134,2195,1582,613,42111.70842824601,46739,30169
32,Erie County (West Central)--Buffalo City (West) PUMA,1566,1298,268,32267.943805874842,32543,30932,646,591,55,47995.510835913316,49204,35000,868,707,161,19800.11520737327,18615,25000,52,0,52,45000.0,0,45000
33,Schenectady County--Schenectady City PUMA,1675,1260,415,47227.34328358209,41311,65187,714,487,227,79668.06722689075,70193,99995,373,185,188,24554.959785522788,25972,23159,588,588,0,22217.34693877551,22217,0
34,NYC-Brooklyn Community District 2--Brooklyn Heights & Fort Greene PUMA,4337,2179,2158,68496.905695181,48095,89096,2359,649,1710,99577.25307333616,87208,104271,1767,1530,237,30935.676287492926,31504,27264,211,0,211,35568.72037914692,0,35568
35,"Steuben (North & West), Schuyler & Chemung (North) Counties PUMA",37,37,0,25000.0,25000,0,0,0,0,#DIV/0!,0,0,37,37,0,25000.0,25000,0,0,0,0,#DIV/0!,0,0
36,NYC-Brooklyn Community District 1--Greenpoint & Williamsburg PUMA,3838,1849,1989,59172.36842105263,56108,62020,1462,395,1067,89638.64569083447,116126,79832,1905,1160,745,44585.1968503937,44427,44830,471,294,177,23603.07855626327,21557,27000
37,Suffolk County (Northwest)--Huntington Town (North) PUMA,3944,2925,1019,38895.70486815416,38655,39583,1036,910,126,49807.43243243243,46734,72000,1348,547,801,45583.086053412466,59078,36367,1560,1468,92,25870.615384615383,26038,23195
38,Erie County (Northeast) PUMA,298,209,89,69093.95973154363,55933,100000,298,209,89,69093.95973154363,55933,100000,0,0,0,#DIV/0!,0,0,0,0,0,#DIV/0!,0,0
39,Monroe County (North & West) PUMA,385,163,222,95174.02597402598,60000,121000,222,0,222,121000.0,0,121000,163,163,0,60000.0,60000,0,0,0,0,#DIV/0!,0,0
40,Oneida County (Central)--Greater Utica & Rome Cities PUMA,1518,1083,435,35278.07641633729,38025,28439,309,309,0,76311.06796116506,76311,0,712,454,258,25896.067415730337,21537,33565,497,320,177,23207.24346076459,24446,20966
41,"NYC-Brooklyn Community District 12--Borough Park, Kensington & Ocean Parkway PUMA",4297,3277,1020,39921.400977426114,41084,36184,1880,1522,358,51756.48936170213,49716,60428,1603,941,662,33797.916406737364,41342,23073,814,814,0,24646.191646191644,24646,0
42,Erie County (West Central)--Buffalo City (East) PUMA,203,0,203,27382.758620689656,0,27382,73,0,73,37100.0,0,37100,48,0,48,30000.0,0,30000,82,0,82,17200.0,0,17200
43,Suffolk County (Northwest)--Smithtown Town PUMA,1503,479,1024,80228.07717897538,86937,77089,640,411,229,79038.75,81467,74680,863,68,795,81110.0811123986,120000,77783,0,0,0,#DIV/0!,0,0
44,Nassau County (Northeast)--Oyster Bay Town (North) & Glen Cove City PUMA,5244,3147,2097,82613.42105263157,93011,67009,2863,1503,1360,113538.3793223891,141265,82895,1236,636,600,61524.91909385113,79425,42550,1145,1008,137,28052.052401746725,29631,16427
45,NYC-Manhattan Community District 8--Upper East Side PUMA,7626,4395,3231,128715.60280618936,148050,102415,7032,3958,3074,134686.3462741752,158860,103560,594,437,157,58031.64983164983,50139,80000,0,0,0,#DIV/0!,0,0
46,Suffolk County (Southwest)--Islip Town (South) PUMA,3116,2029,1087,47010.04492939666,52202,37317,876,614,262,64597.03196347032,68180,56198,1504,840,664,40462.16755319149,44827,34939,736,575,161,39458.15217391304,45914,16400
47,"NYC-Brooklyn Community District 6--Park Slope, Carroll Gardens & Red Hook PUMA",2146,853,1293,91250.89468779124,68217,106446,1801,508,1293,103645.43031649083,96516,106446,188,188,0,32851.063829787236,32851,0,157,157,0,19000.0,19000,0
48,Erie County (South) PUMA,362,333,29,25814.723756906078,25435,30170,29,0,29,30170.0,0,30170,333,333,0,25435.435435435436,25435,0,0,0,0,#DIV/0!,0,0
49,Albany County (Outside Albany City) PUMA,3356,2737,619,83046.45411203815,90276,51076,2894,2473,421,90244.95507947478,94852,63178,462,264,198,37954.545454545456,47412,25344,0,0,0,#DIV/0!,0,0
50,NYC-Staten Island Community District 2--New Springville & South Beach PUMA,6030,3418,2612,51526.79933665008,57035,44317,2269,1210,1059,76995.06390480387,90311,61779,3319,2095,1224,37463.03103344381,38465,35746,442,113,329,26391.402714932126,45000,20000
51,Erie County (North Central) PUMA,1824,1091,733,120131.69956140351,129327,106445,1561,1025,536,137882.9083920564,135594,142259,66,66,0,32000.0,32000,0,197,0,197,9000.0,0,9000
52,"NYC-Staten Island Community District 3--Tottenville, Great Kills & Annadale PUMA",2410,1759,651,65504.80497925311,65091,66620,926,656,270,101168.59611231102,104366,93398,1228,914,314,45399.64169381108,41217,57574,256,189,67,32944.140625,44232,1100
53,"NYC-Manhattan Community District 12--Washington Heights, Inwood & Marble Hill PUMA",18623,9282,9341,31699.249691242014,33513,29896,3839,1586,2253,37335.71242511071,31209,41648,11364,5559,5805,31301.827437522,38312,24588,3420,2137,1283,26692.795321637426,22741,33274
54,NYC-Manhattan Community District 7--Upper West Side & West Side PUMA,6278,2784,3494,103324.49187639376,132194,80320,4798,2302,2496,112972.52188411838,145217,83233,1480,482,998,72046.62162162163,70000,73035,0,0,0,#DIV/0!,0,0
55,"NYC-Queens Community District 5--Ridgewood, Glendale & Middle Village PUMA",9630,4768,4862,52293.172377985466,54696,49936,3460,1275,2185,67812.54335260116,75011,63611,4954,2767,2187,45047.91077916835,50405,38269,1216,726,490,37651.72697368421,35374,41025
56,"NYC-Brooklyn Community District 15--Sheepshead Bay, Gerritsen Beach & Homecrest PUMA",5097,2737,2360,47797.72415146165,50841,44267,2501,1323,1178,58758.480607756894,62622,54419,2059,1051,1008,38767.479358912096,42621,34749,537,363,174,31373.92923649907,31709,30674
57,"NYC-Queens Community District 12--Jamaica, Hollis & St. Albans PUMA",13410,8093,5317,38308.60178970917,37259,39906,5031,2979,2052,48158.757702246075,42715,56061,5789,3658,2131,35752.565209880806,36140,35086,2590,1456,1134,24888.04633204633,28905,19729
58,Suffolk County (North Central)--Brookhaven Town (North) PUMA,1139,856,283,125035.3643546971,137362,87750,864,581,283,118978.33333333333,134189,87750,275,275,0,144065.45454545456,144065,0,0,0,0,#DIV/0!,0,0
59,Albany County (East Central)--Albany City PUMA,361,247,114,40496.95290858726,37137,47775,236,178,58,53559.32203389831,44943,80000,56,0,56,14400.0,0,14400,69,69,0,17000.0,17000,0
60,NYC-Manhattan Community District 3--Chinatown & Lower East Side PUMA,5544,2792,2752,100152.09108946609,74742,125930,3388,1562,1826,141160.94126328218,102378,174336,1637,851,786,36082.07941356139,42987,28605,519,379,140,34534.79768786127,32146,41000
61,Rensselaer County--Troy City PUMA,1188,792,396,33639.0404040404,30778,39360,577,268,309,43679.549393414214,42374,44811,248,161,87,51810.48387096774,69000,20000,363,363,0,5264.683195592286,5264,0
62,Warren & Washington Counties PUMA,108,91,17,33401.851851851854,37400,12000,91,91,0,37400.0,37400,0,17,0,17,12000.0,0,12000,0,0,0,#DIV/0!,0,0
63,Orange County (Northeast)--Greater Newburgh City PUMA,2465,1190,1275,49493.16024340771,57135,42360,823,328,495,65687.72782503038,103250,40797,973,408,565,34858.828365878726,38724,32067,669,454,215,50855.00747384156,40365,73004
64,"Rockland County (South)--Orangetown, Clarkstown (South) & Ramapo (Southeast) Towns PUMA",4902,2700,2202,98527.95797633618,79543,121805,2444,1476,968,91738.6047463175,95670,85743,1862,941,921,130629.43071965629,66742,195903,596,283,313,26078.691275167785,38000,15300
65,Fulton & Montgomery Counties PUMA,302,183,119,41546.35761589404,65311,5000,255,136,119,41831.37254901961,74058,5000,47,47,0,40000.0,40000,0,0,0,0,#DIV/0!,0,0
66,NYC-Brooklyn Community District 11--Bensonhurst & Bath Beach PUMA,16120,8493,7627,49387.88548387097,48879,49953,8143,3836,4307,61662.389045806216,59202,63853,6196,3201,2995,40810.713363460294,47807,33332,1781,1456,325,23106.513194834362,24042,18914
67,Monroe County (Central)--Rochester City (East) PUMA,1513,678,835,31137.11169861203,28219,33506,318,51,267,42805.81761006289,100000,31881,751,337,414,23484.953395472705,26562,20979,444,290,154,35722.97297297297,17520,70000
68,Chautauqua County PUMA,93,93,0,25118.279569892475,25118,0,32,32,0,12000.0,12000,0,0,0,0,#DIV/0!,0,0,61,61,0,32000.0,32000,0
69,Nassau County (Northwest)--North Hempstead Town (North) PUMA,5987,3938,2049,78925.14447970602,76737,83130,3738,1926,1812,87226.5115034778,86471,88029,2181,2012,169,66818.03759743237,67419,59661,68,0,68,10911.764705882353,0,10911
70,"Clinton, Franklin, Essex & Hamilton Counties PUMA",480,317,163,38381.666666666664,36881,41300,377,214,163,42966.57824933687,44235,41300,103,103,0,21600.0,21600,0,0,0,0,#DIV/0!,0,0
71,NYC-Queens Community District 6--Forest Hills & Rego Park PUMA,12362,6168,6194,76823.22714771073,91229,62477,7957,3393,4564,96951.11147417368,131416,71328,3860,2472,1388,40841.072538860106,42219,38386,545,303,242,37802.20183486238,41065,33716
72,Monroe County (Central)--Rochester City (West) PUMA,2119,1404,715,26478.00849457291,28331,22838,345,226,119,64864.057971014496,72743,49900,1713,1117,596,18336.71920607122,18817,17435,61,61,0,38000.0,38000,0
73,Orange County (Southeast) PUMA,2983,1644,1339,101806.48675829702,72844,137365,1394,834,560,164404.08895265425,105291,252439,1302,523,779,51495.73732718894,46808,54642,287,287,0,26000.0,26000,0
74,Rockland County (North)--New City & Congers PUMA,6656,3320,3336,56453.25570913462,56010,56894,2192,1250,942,90350.18248175182,87507,94121,3504,1567,1937,45176.332762557075,41351,48270,960,503,457,20216.041666666668,23401,16709
75,Westchester County (Southeast) PUMA,10005,6596,3409,68342.15892053973,79144,47441,3694,2333,1361,111369.11207363292,136067,69031,4561,2633,1928,47979.39048454286,58385,33768,1750,1630,120,30589.6,31203,22250
76,"NYC-Manhattan Community District 9--Hamilton Heights, Manhattanville & West Harlem PUMA",10081,5277,4804,38640.45233607777,38334,38976,3794,2230,1564,57973.08908803374,48991,70778,3922,1988,1934,30628.65884752677,35895,25215,2365,1059,1306,20912.854122621564,20473,21269
77,Nassau County (Southwest)--Hempstead Town (Southwest) & Long Beach City PUMA,4350,2364,1986,71285.05747126437,73832,68252,2364,773,1591,93067.76649746193,125658,77233,1292,897,395,58524.613003095976,70170,32078,694,694,0,20841.49855907781,20841,0
78,NYC-Queens Community District 2--Sunnyside & Woodside PUMA,21519,14103,7416,45053.26269808077,43630,47758,9269,5731,3538,61570.97421512569,60908,62643,9113,5955,3158,29137.671458356195,25093,36764,3137,2417,720,42482.69046860057,48335,22833
79,"NYC-Bronx Community District 11--Pelham Parkway, Morris Park & Laconia PUMA",8956,5248,3708,46605.31933899062,46026,47425,2881,1832,1049,65658.18812912183,60010,75521,5333,2674,2659,38354.24714044628,40356,36340,742,742,0,31930.99730458221,31930,0
80,Onondaga County (Central)--Syracuse City (Outer) PUMA,804,281,523,49925.87064676617,40577,54948,687,233,454,55424.163027656476,44817,60867,117,48,69,17641.02564102564,20000,16000,0,0,0,#DIV/0!,0,0
81,Wayne & Seneca Counties PUMA,761,612,149,48402.10249671485,27539,134093,692,612,80,47245.66473988439,27539,198000,69,0,69,60000.0,0,60000,0,0,0,#DIV/0!,0,0
82,"NYC-Bronx Community District 7--Bedford Park, Fordham North & Norwood PUMA",11967,7625,4342,37932.36968329573,40533,33364,3436,2352,1084,47398.428405122235,46411,49540,6421,3886,2535,36817.660800498365,40176,31669,2110,1387,723,25909.700473933648,31567,15056
83,Nassau County (West Central)--Hempstead Town (Northwest) PUMA,8753,5575,3178,64341.55146806809,70240,53993,3967,2371,1596,90236.92966977565,106589,65944,3856,2437,1419,43946.70643153527,44255,43416,930,767,163,38444.30107526882,40440,29049
84,NYC-Brooklyn Community District 18--Canarsie & Flatlands PUMA,12666,6556,6110,49092.588030948995,50216,47887,5166,2004,3162,65193.80952380953,76335,58132,5806,3505,2301,42189.838098518776,42612,41545,1694,1047,647,23648.937426210152,25676,20368
85,"NYC-Bronx Community District 12--Wakefield, Williamsbridge & Woodlawn PUMA",4596,2875,1721,50248.68363794604,60165,33682,1821,972,849,52763.37177375069,67584,35794,2503,1631,872,47424.7103475829,55871,31625,272,272,0,59400.0,59400,0
86,Suffolk County (South Central)--Brookhaven Town (South) PUMA,2676,2158,518,38801.49476831091,39892,34254,530,235,295,31496.22641509434,34191,29349,1693,1470,223,45098.05079740106,45758,40744,453,453,0,23816.335540838852,23816,0
87,NYC-Queens Community District 4--Elmhurst & South Corona PUMA,30464,21260,9204,41400.994944852944,40817,42749,11403,8381,3022,56323.41576778041,56365,56207,15232,10006,5226,32409.022452731093,30038,36947,3829,2873,956,32731.723687646907,32998,31930
88,Livingston & Wyoming Counties PUMA,166,0,166,31000.0,0,31000,0,0,0,#DIV/0!,0,0,166,0,166,31000.0,0,31000,0,0,0,#DIV/0!,0,0
89,"NYC-Bronx Community District 10--Co-op City, Pelham Bay & Schuylerville PUMA",5186,2445,2741,49870.01349787891,63665,37563,2280,1223,1057,56920.96052631579,72484,38912,2286,941,1345,52854.98687664042,67521,42594,620,281,339,12934.838709677419,12373,13400
90,Cattaraugus & Allegany Counties PUMA,332,162,170,308474.0060240964,587010,43045,324,162,162,315932.6234567901,587010,44855,8,0,8,6400.0,0,6400,0,0,0,#DIV/0!,0,0
91,Herkimer (North & Central) & Oneida (Outer) Counties PUMA,45,45,0,30188.88888888889,30188,0,9,9,0,90100.0,90100,0,36,36,0,15211.111111111111,15211,0,0,0,0,#DIV/0!,0,0
92,Orange County (Northwest) PUMA,2716,1019,1697,44070.50810014728,51421,39656,1178,350,828,54352.03735144313,58197,52726,1461,592,869,36785.62628336756,50852,27202,77,77,0,25000.0,25000,0
93,Columbia & Greene Counties PUMA,420,333,87,93042.85714285714,111603,22000,246,246,0,144000.0,144000,0,174,87,87,21000.0,20000,22000,0,0,0,#DIV/0!,0,0
94,Suffolk County (East) PUMA,3592,2489,1103,34813.32962138085,35039,34302,734,417,317,57401.49863760218,54008,61864,1650,1158,492,33539.393939393936,34436,31426,1208,914,294,22828.460264900663,27148,9396
95,Monroe County (East) PUMA,1376,696,680,58207.41279069767,46287,70407,517,159,358,94021.27659574468,85000,98027,757,435,322,36201.321003963014,33611,39700,102,102,0,40000.0,40000,0
96,Sullivan & Ulster (West) Counties PUMA,1430,448,982,47859.3006993007,42405,50347,352,122,230,57219.318181818184,44673,63873,1047,295,752,44897.80324737345,41552,46210,31,31,0,41600.0,41600,0
97,Cayuga & Onondaga (South) Counties PUMA,144,144,0,86437.5,86437,0,103,103,0,96961.16504854368,96961,0,41,41,0,60000.0,60000,0,0,0,0,#DIV/0!,0,0
98,"NYC-Bronx Community District 1 & 2--Hunts Point, Longwood & Melrose PUMA",10815,6051,4764,33242.77669902913,35562,30296,2329,986,1343,42634.56419063976,38909,45369,6364,3897,2467,31618.562225015714,37811,21835,2122,1168,954,27805.93779453346,25233,30955
99,Suffolk County (Southwest)--Babylon Town (Southeast) PUMA,2345,1463,882,38759.0618336887,37639,40616,778,587,191,48761.69665809769,54647,30673,995,448,547,34984.3216080402,18527,48462,572,428,144,31720.27972027972,34317,24000
100,Onondaga County (Central)--Syracuse City PUMA,2823,1718,1105,34402.97555791711,35376,32889,1139,665,474,53716.59350307287,52961,54775,1114,715,399,21024.326750448832,23208,17110,570,338,232,21956.666666666668,26517,15311
101,Ulster County (East) PUMA,2453,1615,838,42688.13697513249,45425,37412,580,450,130,88111.03448275862,87276,91000,963,692,271,34874.35098650052,36956,29557,910,473,437,22006.153846153848,17999,26343
102,NYC-Queens Community District 9--Richmond Hill & Woodhaven PUMA,19950,12349,7601,42563.46065162907,46968,35406,5386,3181,2205,55439.31303379131,59289,49885,11722,7064,4658,39137.922709435246,44954,30316,2842,2104,738,32290.70021111893,35102,24273
103,NYC-Brooklyn Community District 13--Brighton Beach & Coney Island PUMA,3156,2005,1151,50681.06463878327,47857,55599,1098,587,511,63069.8451730419,56673,70417,1610,1019,591,42241.335403726705,43473,40117,448,399,49,50647.767857142855,46085,87800
104,Broome County (West Central)--Greater Binghamton City & Greater Johnson City Village PUMA,1205,826,379,76447.13692946058,98136,29176,896,604,292,95408.14732142857,126739,30599,309,222,87,21466.343042071196,20316,24400,0,0,0,#DIV/0!,0,0
105,Nassau County (South Central)--Hempstead Town (Southeast) PUMA,3936,1798,2138,41943.82621951219,40514,43146,1486,556,930,54872.27456258412,59987,51813,2253,1045,1208,33463.249001331555,29983,36473,197,197,0,41411.16751269036,41411,0
106,Saratoga County (Outer) PUMA,273,42,231,23141.391941391943,30000,21894,126,0,126,14828.57142857143,0,14828,147,42,105,30266.666666666668,30000,30373,0,0,0,#DIV/0!,0,0
107,"NYC-Manhattan Community District 4 & 5--Chelsea, Clinton & Midtown Business District PUMA",8503,4176,4327,84904.46077854875,90108,79881,5193,3113,2080,113962.03158097439,110465,119195,2064,773,1291,44935.9496124031,34432,51225,1246,290,956,30008.025682182986,20000,33043
108,NYC-Brooklyn Community District 4--Bushwick PUMA,5618,4301,1317,34147.926308294765,34435,33207,682,447,235,46127.346041055716,51753,35425,3276,2511,765,36392.12454212454,37730,32000,1660,1343,317,24797.349397590362,22512,34478
109,Suffolk County (Central)--Islip Town (East) PUMA,789,567,222,66887.45247148289,59287,86298,316,167,149,105243.67088607595,103832,106825,394,321,73,44523.350253807104,44551,44400,79,79,0,25000.0,25000,0
110,Westchester County (Southwest)--Yonkers City PUMA,11555,7029,4526,56510.471657291215,58548,53345,4943,2487,2456,77125.61197653247,84724,69430,5102,3342,1760,43619.75695805567,47555,36147,1510,1200,310,32581.854304635763,34914,23551
111,Nassau County (West Central)--North Hempstead Town (South) PUMA,11430,5829,5601,72262.15721784777,75554,68835,7055,3823,3232,87302.22423812898,84636,90454,3504,1431,2073,50749.36215753425,63503,41944,871,575,296,36984.500574052814,45163,21096
112,"NYC-Queens Community District 8--Briarwood, Fresh Meadows & Hillcrest PUMA",17009,8332,8677,52721.166323710975,62044,43768,7899,4416,3483,67920.12913026965,78951,53934,8345,3359,4986,37229.02552426603,37692,36916,765,557,208,64780.39215686275,74856,37798
113,Jefferson & Lewis Counties PUMA,260,260,0,119492.30769230769,119492,0,260,260,0,119492.30769230769,119492,0,0,0,0,#DIV/0!,0,0,0,0,0,#DIV/0!,0,0
114,Suffolk County (Central)--Brookhaven Town (West Central) PUMA,2290,1246,1044,86828.76855895197,116893,50947,1136,814,322,132799.3661971831,152735,82400,543,206,337,50944.75138121547,68679,40103,611,226,385,33248.445171849424,31744,34131
115,Suffolk County (Northwest)--Huntington Town (South) PUMA,3655,1766,1889,85825.06155950752,99879,72685,1617,930,687,109468.52195423625,130394,81140,1641,576,1065,45463.98537477148,71251,31517,397,260,137,156356.6750629723,54155,350315
116,NYC-Brooklyn Community District 16--Brownsville & Ocean Hill PUMA,3292,2064,1228,36668.985419198056,39357,32149,771,452,319,52842.801556420236,52034,53987,1047,701,346,41995.319961795605,49634,26518,1474,911,563,24425.644504748983,25160,23237
117,"NYC-Staten Island Community District 1--Port Richmond, Stapleton & Mariner's Harbor PUMA",8633,4887,3746,50632.74643808641,47815,54308,3055,1507,1548,70503.8952536825,62549,78247,4256,2310,1946,44598.237781954886,48472,39999,1322,1070,252,24139.939485627838,25643,17757
118,Chemung (South) & Steuben (East) Counties--Greater Elmira & Greater Corning Cities PUMA,988,631,357,199346.35627530364,288971,40932,988,631,357,199346.35627530364,288971,40932,0,0,0,#DIV/0!,0,0,0,0,0,#DIV/0!,0,0
119,Monroe County (Central)--Greece & Gates Towns PUMA,1385,563,822,41713.35740072202,47081,38036,449,449,0,50910.9131403118,50910,0,936,114,822,37301.282051282054,32000,38036,0,0,0,#DIV/0!,0,0
120,NYC-Queens Community District 3--Jackson Heights & North Corona PUMA,27222,18136,9086,41655.91690544412,43015,38942,6801,4454,2347,60958.991324805174,56721,69000,13458,8453,5005,37167.362906821225,41435,29958,6963,5229,1734,31477.36607784001,33894,24189
121,"NYC-Queens Community District 14--Far Rockaway, Breezy Point & Broad Channel PUMA",3074,1808,1266,53785.16590761223,50467,58522,1655,883,772,62409.06344410876,59315,65946,744,427,317,49502.68817204301,50955,47545,675,498,177,37360.88888888889,34361,45800
122,NYC-Brooklyn Community District 10--Bay Ridge & Dyker Heights PUMA,7257,4323,2934,54664.405401681135,55536,53379,4121,2090,2031,68871.82479980588,73547,64060,2053,1338,715,32188.699464198733,34923,27071,1083,895,188,43209.04893813481,44293,38047
123,Broome (Outer West) & Tioga Counties PUMA,89,89,0,60100.0,60100,0,89,89,0,60100.0,60100,0,0,0,0,#DIV/0!,0,0,0,0,0,#DIV/0!,0,0
124,Putnam County PUMA,3143,1836,1307,48419.5672923958,42808,56301,1489,466,1023,73559.97313633311,101451,60854,997,997,0,25802.306920762287,25802,0,657,373,284,25764.07914764079,15000,39901
125,"NYC-Brooklyn Community District 17--East Flatbush, Farragut & Rugby PUMA",6854,2875,3979,37239.9007878611,33567,39893,1737,354,1383,54527.91018998273,56737,53962,4174,2087,2087,31404.14470531864,30550,32257,943,434,509,31226.299045599153,29174,32975
126,"NYC-Queens Community District 11--Bayside, Douglaston & Little Neck PUMA",13633,7301,6332,58201.162033301545,60174,55925,7886,3835,4051,69373.97539944205,75660,63423,4572,2621,1951,44935.88626421697,45064,44762,1175,845,330,34830.97872340425,36765,29878
127,Nassau County (Central)--Hempstead Town (Northeast) PUMA,5987,3469,2518,58889.04292634041,58830,58969,1800,858,942,70449.5,62432,77751,3797,2269,1528,55736.00210692652,60743,48300,390,342,48,36230.769230769234,37105,30000
128,Suffolk County (Central)--Brookhaven Town (Central) PUMA,5102,2864,2238,58184.82947863583,54868,62429,1936,831,1105,85719.00826446281,81626,88796,2986,1853,1133,41971.5338245144,45186,36714,180,180,0,31000.0,31000,0
129,NYC-Manhattan Community District 10--Central Harlem PUMA,5344,3356,1988,48820.13473053892,43318,58107,3139,2004,1135,65578.84676648614,58693,77735,1462,706,756,30755.882352941175,25325,35826,743,646,97,13563.526244952895,15284,2100
130,"NYC-Bronx Community District 5--Morris Heights, Fordham South & Mount Hope PUMA",10139,5761,4378,31487.266988854917,33668,28616,2486,1857,629,35916.33145615447,37638,30833,6379,3229,3150,31982.113183884623,33049,30887,1274,675,599,20366.954474097332,25712,14343
131,NYC-Manhattan Community District 11--East Harlem PUMA,8761,4864,3897,50909.434996005024,41800,62278,2130,1113,1017,90005.99061032863,92091,87723,4683,2688,1995,45754.17467435405,28968,68370,1948,1063,885,20553.388090349075,21592,19305
132,Westchester County (Northwest) PUMA,6896,3400,3496,55635.72215777262,57621,53704,3035,1331,1704,93991.34761120264,116232,76619,3274,1528,1746,26315.210751374467,20310,31570,587,541,46,20858.94378194208,18806,45000
133,Onondaga County (North) PUMA,1261,335,926,51917.84298176051,50068,52586,755,74,681,63210.596026490064,75000,61929,506,261,245,35067.98418972332,43000,26617,0,0,0,#DIV/0!,0,0
134,NYC-Brooklyn Community District 8--Crown Heights North & Prospect Heights PUMA,3326,1502,1824,40978.38244137102,39062,42555,949,448,501,57195.67966280295,36857,75382,2003,922,1081,35511.382925611586,39782,31868,374,132,242,29107.219251336897,41525,22333
135,NYC-Brooklyn Community District 3--Bedford-Stuyvesant PUMA,2629,1815,814,36922.175732217576,34874,41487,893,809,84,30700.783874580065,31500,23000,1491,761,730,39165.39235412475,34897,43614,245,245,0,45946.93877551021,45946,0
136,Genesee & Orleans Counties PUMA,281,129,152,23729.893238434164,30062,18355,14,14,0,12000.0,12000,0,206,54,152,24029.611650485436,40000,18355,61,61,0,25409.83606557377,25409,0
137,Westchester County (Central)--White Plains City PUMA,9345,5726,3619,71324.151952916,60609,88276,4930,2307,2623,98196.55172413793,89212,106098,2993,2311,682,45096.82592716338,45915,42321,1422,1108,314,33361.74402250352,31702,39216
138,Saratoga County (South & Central) PUMA,1108,593,515,89619.99097472924,93812,84792,890,411,479,100081.96629213484,111000,90713,218,182,36,46908.25688073395,55000,6000,0,0,0,#DIV/0!,0,0
139,Monroe County (South) PUMA,3653,1793,1860,91680.39419655078,130855,53916,2793,1403,1390,107120.40100250626,156303,57477,584,390,194,28841.095890410958,39307,7800,276,0,276,68398.55072463768,0,68398
140,Suffolk County (Central)--Islip Town (Northwest) PUMA,15915,8855,7060,40825.41753063148,44777,35868,2018,685,1333,47558.07730426164,54775,43849,11173,6130,5043,39051.706793162084,41562,35999,2724,2040,684,43112.922173274594,51079,19352
141,St. Lawrence County PUMA,318,0,318,36129.24528301887,0,36129,19,0,19,33000.0,0,33000,299,0,299,36328.09364548495,0,36328,0,0,0,#DIV/0!,0,0
142,Nassau County (West Central)--Hempstead Town (West Central) PUMA,7608,3740,3868,54069.62407991588,50686,57340,3205,1436,1769,62785.553822152884,60780,64412,4352,2253,2099,47874.310661764706,44607,51380,51,51,0,35000.0,35000,0
143,Nassau County (Central)--Hempstead Town (North Central)--Meadowbrook Corridor PUMA,6750,4277,2473,40635.444444444445,40602,40692,1402,604,798,61784.59343794579,52386,68898,3184,1868,1316,33907.0351758794,38953,26743,2164,1805,359,36833.29482439926,38365,29129
144,"NYC-Bronx Community District 9--Castle Hill, Clason Point & Parkchester PUMA",9944,6272,3672,38510.35800482703,39788,36326,3269,1725,1544,48634.475374732334,48276,49034,5871,4142,1729,35204.30931698177,37586,29497,804,405,399,21488.059701492537,26160,16745
145,Nassau County (Southeast)--Oyster Bay Town (South) PUMA,2911,1470,1441,46745.01889385091,55452,37861,498,228,270,76475.70281124498,100789,55944,2312,1242,1070,40198.89705882353,47130,32153,101,0,101,50000.0,0,50000
146,Capital Region,8489,6095,2394,443615.88261907804,472317,344084,5774,4154,1620,563462.4314543844,544762,393525,1695,921,774,238894.9126584366,247384,153276,1020,1020,0,#DIV/0!,44481,0
147,Central NY,5537,2940,2597,273778.43873957766,249498,170423,2717,1108,1609,#DIV/0!,324739,177571,2250,1494,756,183037.17460496264,181458,89727,570,338,232,#DIV/0!,26517,15311
148,Finger Lakes,12434,6237,6197,468195.13647900964,411649,546293,5471,2914,2557,#DIV/0!,504495,616648,6019,2809,3210,332742.31257454,263572,246966,944,514,430,#DIV/0!,120929,138398
149,Long Island,123009,71978,51031,1549587.9046712157,1662709,1400270,46914,24849,22065,1997970.7447012283,2141850,1805751,58176,33271,24905,1331408.4191311875,1518759,981449,17919,13858,4061,#DIV/0!,722279,753494
150,Mid-Hudson,94639,52614,42025,1029438.8081109349,1010346,1053554,38432,19058,19374,1506292.431438728,1681787,1405686,41852,22990,18862,765060.7181162244,724829,777034,14355,10566,3789,489242.3058966504,479917,383737
151,Mohawk Valley,1961,1368,593,158685.8229211202,177307,96641,637,490,147,257615.87801018468,292469,50996,814,545,269,164233.49431631513,127048,140565,510,333,177,#DIV/0!,41466,20966
152,New York City,553712,318050,235662,3017661.5743327374,3109736,2955612,219808,116582,103226,3933439.418843176,4018122,3847393,259082,150756,108326,2243937.3905394915,2296706,2068039,74822,50712,24110,#DIV/0!,1623141,1320648
153,North Country,1058,577,481,194003.21964199323,156373,77429,656,474,182,195458.88594164455,163727,74300,402,103,299,#DIV/0!,21600,36328,0,0,0,#DIV/0!,0,0
154,Southern Tier,4718,2910,1808,470061.22899099014,583507,177107,3938,2300,1638,#DIV/0!,589259,205199,780,610,170,#DIV/0!,110986,36400,0,0,0,#DIV/0!,0,0
155,Western NY,7496,5062,2434,735759.7142641736,1001162,417111,3699,2570,1129,#DIV/0!,989098,521384,2965,2262,703,#DIV/0!,149662,124900,832,230,602,#DIV/0!,120000,98200
