,puma,Total_geo,Total_geo_m,Total_geo_f,Total_Avg_PINCP_mf_t,Total_Avg_PINCP_m,Total_Avg_PINCP_f,Total_BABS,Total_BABS_m,Total_BABS_f,BABS_Avg_PINCP_mf_t,BABS_Avg_PINCP_m,BABS_Avg_PINCP_f,Total_HS,Total_HS_m,Total_HS_f,HS_Avg_PINCP_mf_t,HS_Avg_PINCP_m,HS_Avg_PINCP_f,Total_HSINC,Total_HSINC_m,Total_HSINC_f,HSINC_Avg_PINCP_mf_t,HSINC_Avg_PINCP_m,HSINC_Avg_PINCP_f
0,Total Geo,388165,242316,145849,43473.37718238378,45718.50323544462,39743.28671434154,85500,40852,44648,68389.82339181287,80070.4415940468,57702.29842322165,213067,131500,81567,38838.501241393555,41848.404410646384,33986.02086628171,89598,69964,19634,30718.43802317016,32934.394402835744,22822.075990628502
1,NYC-Manhattan Community District 7--Upper West Side & West Side PUMA,2229,1628,601,114355.4957379991,111802.2113022113,121271.88019966723,1938,1337,601,119363.9834881321,118506.35751682872,121271.88019966723,291,291,0,81000.0,81000.0,0.0,0,0,0,#DIV/0!,0.0,0.0
2,Nassau County (West Central)--Hempstead Town (Northwest) PUMA,2369,1005,1364,60572.35120303926,88876.51741293533,39717.74193548387,234,213,21,159293.1623931624,170563.38028169013,44980.95238095238,1812,469,1343,53322.51655629139,92515.99147121535,39635.443037974685,323,323,0,29724.148606811144,29724.148606811144,0.0
3,NYC-Brooklyn Community District 2--Brooklyn Heights & Fort Greene PUMA,637,250,387,39771.11459968603,46247.2,35587.59689922481,267,208,59,38794.0074906367,41572.11538461538,29000.0,370,42,328,40476.21621621621,69400.0,36772.560975609755,0,0,0,#DIV/0!,0.0,0.0
4,Madison & Cortland Counties PUMA,0,0,0,#DIV/0!,0.0,0.0,0,0,0,#DIV/0!,0.0,0.0,0,0,0,#DIV/0!,0.0,0.0,0,0,0,#DIV/0!,0.0,0.0
5,Ontario & Yates Counties PUMA,92,92,0,28000.0,28000.0,0.0,0,0,0,#DIV/0!,0.0,0.0,0,0,0,#DIV/0!,0.0,0.0,92,92,0,28000.0,28000.0,0.0
6,Monroe County (Central)--Greece & Gates Towns PUMA,0,0,0,#DIV/0!,0.0,0.0,0,0,0,#DIV/0!,0.0,0.0,0,0,0,#DIV/0!,0.0,0.0,0,0,0,#DIV/0!,0.0,0.0
7,Nassau County (East Central)--Oyster Bay Town (Central) PUMA,777,176,601,48359.07335907336,64392.045454545456,43663.89351081531,356,112,244,51974.7191011236,66901.78571428571,45122.95081967213,350,64,286,42928.57142857143,60000.0,39108.39160839161,71,0,71,57000.0,0.0,57000.0
8,"Clinton, Franklin, Essex & Hamilton Counties PUMA",199,199,0,27000.0,27000.0,0.0,0,0,0,#DIV/0!,0.0,0.0,199,199,0,27000.0,27000.0,0.0,0,0,0,#DIV/0!,0.0,0.0
9,NYC-Manhattan Community District 8--Upper East Side PUMA,2059,1180,879,104269.73773676543,147914.7372881356,45679.180887372015,1438,709,729,126788.17107093184,210041.45275035262,45818.93004115226,357,207,150,53697.47899159664,60000.0,45000.0,264,264,0,50000.0,50000.0,0.0
10,Suffolk County (Southwest)--Islip Town (South) PUMA,1398,326,1072,29978.755364806868,56070.552147239265,22044.123134328358,63,63,0,80000.0,80000.0,0.0,309,250,59,44179.611650485436,51656.0,12500.0,1026,13,1013,22630.409356725148,25000.0,22600.0
11,Erie County (Northwest) PUMA,223,223,0,37800.0,37800.0,0.0,0,0,0,#DIV/0!,0.0,0.0,223,223,0,37800.0,37800.0,0.0,0,0,0,#DIV/0!,0.0,0.0
12,"NYC-Queens Community District 8--Briarwood, Fresh Meadows & Hillcrest PUMA",6601,3675,2926,40364.40539312225,42243.26530612245,38004.59330143541,2261,1118,1143,49581.15877930119,56627.90697674418,42688.53893263342,2579,1288,1291,42865.622334238076,49340.06211180124,36406.22773044152,1761,1269,492,24867.688813174333,22367.2182821119,31317.073170731706
13,NYC-Brooklyn Community District 5--East New York & Starrett City PUMA,8443,4941,3502,46351.79793912116,52220.54847196924,38071.53055396916,1069,624,445,80247.52104770814,84068.91025641025,74888.98876404495,6088,3676,2412,44822.508212877794,51428.65342763874,34754.43615257048,1286,641,645,25415.396578538104,25758.190327613105,25074.728682170542
14,Rockland County (North)--New City & Congers PUMA,3245,1915,1330,47042.588597842834,40657.963446475194,56235.48872180451,69,0,69,50000.0,0.0,50000.0,2551,1362,1189,48827.98902391219,41187.22466960352,57580.48780487805,625,553,72,39428.8,39354.43037974684,40000.0
15,"Otsego, Schoharie, Oneida (South) & Herkimer (South) Counties PUMA",29,7,22,19189.655172413793,50000.0,9386.363636363636,15,0,15,2100.0,0.0,2100.0,7,0,7,25000.0,0.0,25000.0,7,7,0,50000.0,50000.0,0.0
16,NYC-Brooklyn Community District 7--Sunset Park & Windsor Terrace PUMA,5736,3863,1873,35836.793933054396,42103.11933730262,22912.706887346503,1080,581,499,46433.333333333336,58913.941480206544,31901.803607214428,2429,1543,886,27161.34211609716,28595.46338302009,24663.769751693002,2227,1739,488,40160.28289178267,48471.85163887292,10541.803278688525
17,NYC-Brooklyn Community District 11--Bensonhurst & Bath Beach PUMA,3794,2696,1098,31646.63943068002,33939.873887240356,26015.89253187614,575,342,233,16186.08695652174,21000.0,9120.171673819743,2042,1393,649,25966.62585700294,22355.34816941852,33717.79661016949,1177,961,216,49053.950722175025,55337.04474505723,21100.0
18,Tompkins County PUMA,11,11,0,25000.0,25000.0,0.0,0,0,0,#DIV/0!,0.0,0.0,0,0,0,#DIV/0!,0.0,0.0,11,11,0,25000.0,25000.0,0.0
19,Dutchess County (Southwest) PUMA,1858,1323,535,36424.11194833154,40906.80272108843,25338.8785046729,88,88,0,46800.0,46800.0,0.0,1114,579,535,35679.263913824056,45233.85146804836,25338.8785046729,656,656,0,36297.10365853659,36297.10365853659,0.0
20,NYC-Queens Community District 9--Richmond Hill & Woodhaven PUMA,10188,6228,3960,49324.51904201021,53998.0732177264,41974.292929292926,2690,1337,1353,57981.4498141264,71762.90201944653,44362.9711751663,6432,3825,2607,47890.034203980096,52766.95424836601,40734.59915611814,1066,1066,0,36134.52157598499,36134.52157598499,0.0
21,Westchester County (Northwest) PUMA,5108,4571,537,29599.060297572436,29949.704659811858,26614.33891992551,441,394,47,41698.4126984127,43690.35532994924,25000.0,3101,2611,490,29547.50080619155,30068.900804289544,26769.183673469386,1566,1566,0,26293.869731800765,26293.869731800765,0.0
22,Albany County (Outside Albany City) PUMA,488,304,184,46287.41803278688,58566.64473684211,26000.0,219,219,0,71245.47945205479,71245.47945205479,0.0,85,85,0,25900.0,25900.0,0.0,184,0,184,26000.0,0.0,26000.0
23,Monroe County (South) PUMA,778,684,94,51611.43958868895,50733.47953216374,58000.0,94,0,94,58000.0,0.0,58000.0,327,327,0,38033.94495412844,38033.94495412844,0.0,357,357,0,62365.82633053221,62365.82633053221,0.0
24,Jefferson & Lewis Counties PUMA,709,687,22,65002.82087447109,66251.81950509461,26000.0,525,503,22,82527.61904761905,85000.0,26000.0,184,184,0,15000.0,15000.0,0.0,0,0,0,#DIV/0!,0.0,0.0
25,"Chenango, Delaware & Broome (East) Counties PUMA",41,41,0,20000.0,20000.0,0.0,0,0,0,#DIV/0!,0.0,0.0,0,0,0,#DIV/0!,0.0,0.0,41,41,0,20000.0,20000.0,0.0
26,Erie County (Central) PUMA,394,209,185,24853.299492385788,27551.196172248805,21805.405405405407,169,93,76,23094.674556213016,15000.0,33000.0,225,116,109,26174.222222222223,37613.793103448275,14000.0,0,0,0,#DIV/0!,0.0,0.0
27,St. Lawrence County PUMA,62,62,0,72000.0,72000.0,0.0,62,62,0,72000.0,72000.0,0.0,0,0,0,#DIV/0!,0.0,0.0,0,0,0,#DIV/0!,0.0,0.0
28,"NYC-Manhattan Community District 9--Hamilton Heights, Manhattanville & West Harlem PUMA",8716,5495,3221,35131.597062872876,38934.12192902639,28644.520335299596,1937,1386,551,63268.198244708314,64579.72582972583,59969.14700544465,3786,2205,1581,36201.3734812467,39718.36734693877,31296.268184693232,2993,1904,1089,15569.027731373204,19357.405462184874,8945.454545454546
29,Suffolk County (North Central)--Brookhaven Town (North) PUMA,767,517,250,43534.55019556714,37885.88007736944,55216.0,385,178,207,69579.22077922078,75359.55056179775,64608.69565217391,194,151,43,10778.350515463917,11000.0,10000.0,188,188,0,24000.0,24000.0,0.0
30,NYC-Brooklyn Community District 1--Greenpoint & Williamsburg PUMA,3920,2438,1482,30668.933673469386,26637.448728465955,37301.02564102564,730,213,517,46169.04109589041,38347.41784037559,49391.48936170213,1709,1359,350,29609.373902867173,25246.578366445916,46549.485714285714,1481,866,615,24251.45172180959,25939.953810623556,21873.82113821138
31,Cayuga & Onondaga (South) Counties PUMA,526,437,89,45656.65399239544,44364.75972540046,52000.0,382,293,89,34972.25130890052,29800.0,52000.0,144,144,0,74000.0,74000.0,0.0,0,0,0,#DIV/0!,0.0,0.0
32,Nassau County (Southeast)--Oyster Bay Town (South) PUMA,1033,500,533,81249.08034849951,127268.6,38078.79924953096,181,181,0,234719.88950276244,234719.88950276244,0.0,852,319,533,48645.53990610329,66300.94043887148,38078.79924953096,0,0,0,#DIV/0!,0.0,0.0
33,Fulton & Montgomery Counties PUMA,0,0,0,#DIV/0!,0.0,0.0,0,0,0,#DIV/0!,0.0,0.0,0,0,0,#DIV/0!,0.0,0.0,0,0,0,#DIV/0!,0.0,0.0
34,Onondaga County (Central)--Syracuse City (Outer) PUMA,242,150,92,50938.842975206615,52128.0,49000.0,134,42,92,50880.59701492537,55000.0,49000.0,66,66,0,50000.0,50000.0,0.0,42,42,0,52600.0,52600.0,0.0
35,NYC-Staten Island Community District 2--New Springville & South Beach PUMA,1048,896,152,43023.6641221374,38606.919642857145,69059.21052631579,78,78,0,100000.0,100000.0,0.0,895,743,152,40406.48044692737,34544.81830417227,69059.21052631579,75,75,0,15000.0,15000.0,0.0
36,Niagara County (Southwest)--Greater Niagara Falls & North Tonawanda Area PUMA,358,358,0,21178.77094972067,21178.77094972067,0.0,0,0,0,#DIV/0!,0.0,0.0,358,358,0,21178.77094972067,21178.77094972067,0.0,0,0,0,#DIV/0!,0.0,0.0
37,Suffolk County (Central)--Brookhaven Town (Central) PUMA,3524,2365,1159,45599.17707150965,50647.56871035941,35297.670405522,128,128,0,75000.0,75000.0,0.0,1770,1327,443,54055.08474576271,58159.38206480784,41760.722347629795,1626,910,716,34079.950799508,36268.131868131866,31298.882681564246
38,"NYC-Bronx Community District 7--Bedford Park, Fordham North & Norwood PUMA",7186,4088,3098,34692.48538825494,34618.51761252446,34790.0903808909,1746,811,935,49081.099656357386,35783.72379778052,60614.97326203209,3603,2327,1276,35679.961143491535,41320.67039106145,25393.18181818182,1837,950,887,19079.858464888406,17207.052631578947,21085.682074408116
39,NYC-Queens Community District 4--Elmhurst & South Corona PUMA,9673,7423,2250,34467.02884317171,35238.255422335984,31922.666666666668,1381,738,643,28134.974656046343,32545.257452574526,23073.094867807155,6139,4860,1279,37506.77146115003,39789.52057613169,28832.68178264269,2153,1825,328,29861.1704598235,24207.178082191782,61320.12195121951
40,"NYC-Brooklyn Community District 6--Park Slope, Carroll Gardens & Red Hook PUMA",1353,570,783,115280.41389504804,152949.8245614035,87858.23754789271,1353,570,783,115280.41389504804,152949.8245614035,87858.23754789271,0,0,0,#DIV/0!,0.0,0.0,0,0,0,#DIV/0!,0.0,0.0
41,Suffolk County (Central)--Islip Town (East) PUMA,271,83,188,33606.64206642067,7800.0,45000.0,0,0,0,#DIV/0!,0.0,0.0,271,83,188,33606.64206642067,7800.0,45000.0,0,0,0,#DIV/0!,0.0,0.0
42,"NYC-Brooklyn Community District 9--Crown Heights South, Prospect Lefferts & Wingate PUMA",881,440,441,38013.847900113506,37657.27272727273,38369.61451247166,187,105,82,55508.021390374335,52000.0,60000.0,611,252,359,35731.58756137479,39011.90476190476,33428.96935933147,83,83,0,15400.0,15400.0,0.0
43,"NYC-Queens Community District 7--Flushing, Murray Hill & Whitestone PUMA",8041,4135,3906,44669.08593458525,45445.557436517534,43847.09165386585,2022,589,1433,64788.74381800198,90405.77249575552,54259.483600837404,4624,2151,2473,41162.435121107264,45012.64528126453,37813.546300040434,1395,1395,0,27129.878136200718,27129.878136200718,0.0
44,NYC-Queens Community District 3--Jackson Heights & North Corona PUMA,22007,14477,7530,33288.4150497569,32719.33066243006,34382.52324037185,1872,618,1254,54703.418803418805,53988.67313915858,55055.66188197767,15480,9780,5700,33533.66602067184,34416.12985685072,32019.543859649122,4655,4079,576,23860.837808807733,25428.536405981857,12759.027777777777
45,Saratoga County (Outer) PUMA,294,294,0,129455.78231292516,129455.78231292516,0.0,294,294,0,129455.78231292516,129455.78231292516,0.0,0,0,0,#DIV/0!,0.0,0.0,0,0,0,#DIV/0!,0.0,0.0
46,"NYC-Bronx Community District 12--Wakefield, Williamsbridge & Woodlawn PUMA",4196,2362,1834,39607.85986653956,48475.22438611346,28187.62268266085,644,249,395,51240.683229813665,50530.12048192771,51688.60759493671,2844,1405,1439,36239.86638537271,51094.00711743772,21736.69214732453,708,708,0,42555.64971751413,42555.64971751413,0.0
47,"NYC-Brooklyn Community District 15--Sheepshead Bay, Gerritsen Beach & Homecrest PUMA",1922,978,944,35808.37669094693,34251.53374233129,37421.292372881355,0,0,0,#DIV/0!,0.0,0.0,1580,636,944,36914.36708860759,36161.94968553459,37421.292372881355,342,342,0,30698.830409356724,30698.830409356724,0.0
48,Wayne & Seneca Counties PUMA,0,0,0,#DIV/0!,0.0,0.0,0,0,0,#DIV/0!,0.0,0.0,0,0,0,#DIV/0!,0.0,0.0,0,0,0,#DIV/0!,0.0,0.0
49,Schenectady County--Schenectady City PUMA,806,288,518,141287.841191067,287756.94444444444,59853.28185328186,364,0,364,55560.43956043956,0.0,55560.43956043956,442,288,154,211886.8778280543,287756.94444444444,70000.0,0,0,0,#DIV/0!,0.0,0.0
50,NYC-Brooklyn Community District 10--Bay Ridge & Dyker Heights PUMA,2008,1084,924,38731.822709163345,41033.85608856088,36031.168831168834,585,272,313,47574.70085470085,65000.0,32431.948881789136,1423,812,611,35096.48629655657,33005.7881773399,37874.95908346972,0,0,0,#DIV/0!,0.0,0.0
51,Nassau County (Northwest)--North Hempstead Town (North) PUMA,1031,487,544,67845.78079534433,109802.8747433265,30284.926470588234,57,0,57,85000.0,0.0,85000.0,674,487,187,84887.24035608309,109802.8747433265,20000.0,300,0,300,26300.0,0.0,26300.0
52,Suffolk County (West Central)--Babylon Town (Northwest) PUMA,5148,3641,1507,46575.2331002331,44424.47129909365,51771.59920371599,459,98,361,78932.46187363834,75000.0,80000.0,3775,2949,826,46502.51655629139,45901.66158019668,48647.699757869246,914,594,320,30626.148796498906,32046.296296296296,27990.0
53,"NYC-Manhattan Community District 4 & 5--Chelsea, Clinton & Midtown Business District PUMA",1901,1413,488,84369.98947922146,88713.55272469923,71793.23770491804,1144,1009,135,96997.68356643357,91307.48265609515,139526.66666666666,757,404,353,65286.65785997358,82235.14851485149,45889.51841359773,0,0,0,#DIV/0!,0.0,0.0
54,Columbia & Greene Counties PUMA,205,156,49,29849.756097560974,31058.97435897436,26000.0,0,0,0,#DIV/0!,0.0,0.0,108,108,0,30196.296296296296,30196.296296296296,0.0,97,48,49,29463.917525773195,33000.0,26000.0
55,Rensselaer County--Troy City PUMA,266,210,56,16639.84962406015,16597.14285714286,16800.0,79,23,56,14237.974683544304,8000.0,16800.0,151,151,0,17000.0,17000.0,0.0,36,36,0,20400.0,20400.0,0.0
56,Erie County (West Central)--Buffalo City (West) PUMA,783,341,442,41656.704980842915,58503.22580645161,28659.72850678733,532,341,191,51727.81954887218,58503.22580645161,39631.41361256545,70,0,70,25000.0,0.0,25000.0,181,0,181,18497.237569060773,0.0,18497.237569060773
57,Erie County (South) PUMA,344,0,344,33000.0,0.0,33000.0,344,0,344,33000.0,0.0,33000.0,0,0,0,#DIV/0!,0.0,0.0,0,0,0,#DIV/0!,0.0,0.0
58,Oneida County (Central)--Greater Utica & Rome Cities PUMA,170,0,170,20876.70588235294,0.0,20876.70588235294,39,0,39,35000.0,0.0,35000.0,131,0,131,16672.06106870229,0.0,16672.06106870229,0,0,0,#DIV/0!,0.0,0.0
59,"NYC-Manhattan Community District 12--Washington Heights, Inwood & Marble Hill PUMA",20630,12250,8380,29465.8547746001,28035.34693877551,31556.99093078759,2855,1555,1300,37009.98248686515,38094.66237942122,35712.53846153846,13235,7142,6093,29995.488024178314,28881.601792215064,31301.14623338257,4540,3553,987,23177.70925110132,21931.719673515337,27663.019250253292
60,NYC-Brooklyn Community District 13--Brighton Beach & Coney Island PUMA,664,188,476,23981.927710843374,15000.0,27529.41176470588,0,0,0,#DIV/0!,0.0,0.0,298,0,298,38000.0,0.0,38000.0,366,188,178,12568.306010928962,15000.0,10000.0
61,NYC-Manhattan Community District 10--Central Harlem PUMA,1682,762,920,25465.576694411415,23216.666666666668,27328.260869565216,606,81,525,37781.02310231023,42300.0,37083.80952380953,395,0,395,14362.025316455696,0.0,14362.025316455696,681,681,0,20946.842878120413,20946.842878120413,0.0
62,Nassau County (West Central)--North Hempstead Town (South) PUMA,3180,2579,601,40607.201257861634,39896.35517642497,43657.57071547421,523,391,132,86906.30975143403,92716.11253196931,69696.9696969697,1902,1619,283,33694.90010515247,32587.831995058677,40028.268551236746,755,569,186,25948.60927152318,24395.43057996485,30700.0
63,NYC-Brooklyn Community District 16--Brownsville & Ocean Hill PUMA,1971,701,1270,29404.66768138001,43623.39514978602,21556.377952755905,356,99,257,41184.269662921346,61000.0,33550.97276264591,1302,289,1013,20103.6866359447,25678.200692041522,18513.326752221124,313,313,0,54696.485623003195,54696.485623003195,0.0
64,Albany County (East Central)--Albany City PUMA,895,287,608,35741.899441340785,25000.0,40812.5,0,0,0,#DIV/0!,0.0,0.0,608,0,608,40812.5,0.0,40812.5,287,287,0,25000.0,25000.0,0.0
65,Nassau County (West Central)--Hempstead Town (West Central) PUMA,2879,2136,743,57354.98436957277,61416.19850187266,45679.676985195154,360,300,60,83513.88888888889,87216.66666666667,65000.0,1828,1145,683,55897.70240700219,63005.240174672486,43982.43045387994,691,691,0,47581.76555716353,47581.76555716353,0.0
66,Chemung (South) & Steuben (East) Counties--Greater Elmira & Greater Corning Cities PUMA,104,104,0,45000.0,45000.0,0.0,0,0,0,#DIV/0!,0.0,0.0,104,104,0,45000.0,45000.0,0.0,0,0,0,#DIV/0!,0.0,0.0
67,"NYC-Bronx Community District 3 & 6--Belmont, Crotona Park East & East Tremont PUMA",7325,4191,3134,32332.109215017066,31835.743259365307,32995.88385449904,1682,558,1124,32428.35909631391,29585.304659498208,33839.76868327402,4621,2754,1867,33660.636225925125,33770.51561365287,33498.55382967327,1022,879,143,26166.731898238748,27202.50284414107,19800.0
68,"NYC-Bronx Community District 5--Morris Heights, Fordham South & Mount Hope PUMA",6760,3658,3102,31444.541420118345,32204.94805904866,30547.84010315925,1376,366,1010,37493.96802325582,46562.84153005465,34207.623762376235,3828,2217,1611,32101.201671891326,32634.506089309878,31367.287399130975,1556,1075,481,24479.43444730077,26430.697674418603,20118.50311850312
69,"NYC-Bronx Community District 8--Riverdale, Fieldston & Kingsbridge PUMA",5110,2684,2426,44113.85518590998,42255.3651266766,46169.99175597692,1411,443,968,59655.988660524454,73835.2144469526,53166.94214876033,3178,1720,1458,41231.02580239144,40982.20930232558,41524.554183813445,521,521,0,19606.525911708253,19606.525911708253,0.0
70,Erie County (Northeast) PUMA,0,0,0,#DIV/0!,0.0,0.0,0,0,0,#DIV/0!,0.0,0.0,0,0,0,#DIV/0!,0.0,0.0,0,0,0,#DIV/0!,0.0,0.0
71,NYC-Manhattan Community District 11--East Harlem PUMA,2817,1713,1104,39641.00106496273,26523.642732049037,59994.29347826087,1164,159,1005,60217.09621993127,45440.25157232704,62554.92537313433,1064,965,99,30314.84962406015,29936.78756476684,34000.0,589,589,0,15825.127334465195,15825.127334465195,0.0
72,Orange County (Southeast) PUMA,932,400,532,40571.459227467814,55739.0,29167.293233082706,397,50,347,28919.395465994963,70000.0,23000.0,535,350,185,49217.943925233645,53701.71428571428,40735.13513513513,0,0,0,#DIV/0!,0.0,0.0
73,Westchester County (Southeast) PUMA,7067,5051,2016,48903.69322201783,48654.52385666205,49527.97619047619,2058,943,1115,87173.4693877551,127539.76670201485,53034.08071748879,2030,1234,796,39381.97044334975,33577.795786061586,48379.89949748744,2979,2874,105,28954.011413225915,29244.606819763398,21000.0
74,NYC-Queens Community District 1--Astoria & Long Island City PUMA,7005,4679,2326,42480.02855103498,44015.13143834152,39392.00343938091,2238,1339,899,43448.30205540661,49644.73487677371,34219.13236929922,3337,1992,1345,38881.63020677255,34679.71887550201,45104.832713754644,1430,1348,82,49361.74825174825,52218.471810089024,2400.0
75,Livingston & Wyoming Counties PUMA,234,188,46,35123.931623931625,37526.59574468085,25304.347826086956,0,0,0,#DIV/0!,0.0,0.0,67,31,36,24462.68656716418,25000.0,24000.0,167,157,10,39401.19760479042,40000.0,30000.0
76,Suffolk County (Central)--Brookhaven Town (West Central) PUMA,1875,1249,626,67589.86666666667,77665.49239391513,47486.90095846645,68,0,68,110000.0,0.0,110000.0,1222,935,287,81181.83306055647,92207.70053475935,45261.324041811844,585,314,271,34268.03418803419,34363.05732484077,34157.9335793358
77,Westchester County (Southwest)--Yonkers City PUMA,10345,6813,3532,49878.15853069116,51771.97269925143,46225.113250283124,1520,469,1051,101846.54605263157,128724.41364605544,89852.52140818269,6954,4863,2091,40765.64567155594,45698.581122763724,29293.208990913437,1871,1481,390,41527.7926242651,47345.37474679271,19435.897435897437
78,Erie County (North Central) PUMA,506,81,425,61529.644268774704,36000.0,66395.29411764706,385,81,304,67636.1038961039,36000.0,76065.46052631579,121,0,121,42100.0,0.0,42100.0,0,0,0,#DIV/0!,0.0,0.0
79,Saratoga County (South & Central) PUMA,88,0,88,68000.0,0.0,68000.0,88,0,88,68000.0,0.0,68000.0,0,0,0,#DIV/0!,0.0,0.0,0,0,0,#DIV/0!,0.0,0.0
80,Suffolk County (South Central)--Brookhaven Town (South) PUMA,3656,2674,982,44901.80525164114,52430.81525804039,24400.20366598778,380,89,291,40350.0,84000.0,27000.0,1952,1625,327,37899.59016393442,38304.0,35889.908256880735,1324,960,364,56531.72205438066,73416.66666666667,12000.0
81,"NYC-Staten Island Community District 3--Tottenville, Great Kills & Annadale PUMA",175,175,0,62200.0,62200.0,0.0,86,86,0,80000.0,80000.0,0.0,89,89,0,45000.0,45000.0,0.0,0,0,0,#DIV/0!,0.0,0.0
82,Herkimer (North & Central) & Oneida (Outer) Counties PUMA,107,107,0,12000.0,12000.0,0.0,0,0,0,#DIV/0!,0.0,0.0,0,0,0,#DIV/0!,0.0,0.0,107,107,0,12000.0,12000.0,0.0
83,Niagara County (North & East) PUMA,71,71,0,65000.0,65000.0,0.0,0,0,0,#DIV/0!,0.0,0.0,71,71,0,65000.0,65000.0,0.0,0,0,0,#DIV/0!,0.0,0.0
84,Monroe County (Central)--Rochester City (East) PUMA,840,380,460,21682.54761904762,25251.052631578947,18734.652173913044,0,0,0,#DIV/0!,0.0,0.0,562,380,182,20672.241992882562,25251.052631578947,11112.087912087913,278,0,278,23724.96402877698,0.0,23724.96402877698
85,Warren & Washington Counties PUMA,55,0,55,82000.0,0.0,82000.0,55,0,55,82000.0,0.0,82000.0,0,0,0,#DIV/0!,0.0,0.0,0,0,0,#DIV/0!,0.0,0.0
86,Nassau County (Southwest)--Hempstead Town (Southwest) & Long Beach City PUMA,1882,1447,435,77633.79383634431,54019.765031098825,156184.36781609195,632,278,354,161632.59493670886,127550.35971223022,188397.74011299436,991,910,81,40277.09384460141,42491.42857142857,15400.0,259,259,0,15600.0,15600.0,0.0
87,NYC-Brooklyn Community District 8--Crown Heights North & Prospect Heights PUMA,1201,146,1055,55861.94837635304,50958.90410958904,56540.473933649286,828,146,682,62844.444444444445,50958.90410958904,65388.85630498534,373,0,373,40361.93029490617,0.0,40361.93029490617,0,0,0,#DIV/0!,0.0,0.0
88,Onondaga County (Central)--Syracuse City PUMA,822,593,229,51700.7299270073,55187.18381112985,42672.489082969434,0,0,0,#DIV/0!,0.0,0.0,790,561,229,52134.17721518988,55996.43493761141,42672.489082969434,32,32,0,41000.0,41000.0,0.0
89,Westchester County (Central)--White Plains City PUMA,5027,2899,2128,62880.942908295205,61262.40082787168,65085.9022556391,2014,522,1492,85757.69612711023,106857.47126436782,78375.60321715818,2077,1603,474,59421.23254694271,65256.08234560199,39688.60759493671,936,774,162,21333.97435897436,22241.08527131783,17000.0
90,NYC-Brooklyn Community District 3--Bedford-Stuyvesant PUMA,2072,850,1222,43100.096525096524,50085.882352941175,38240.916530278235,459,0,459,71627.45098039215,0.0,71627.45098039215,1140,533,607,32707.719298245614,51018.761726078796,16628.995057660624,473,317,156,40464.27061310782,48517.35015772871,24100.0
91,"NYC-Bronx Community District 1 & 2--Hunts Point, Longwood & Melrose PUMA",7483,4842,2641,40028.785246558866,44966.336224700535,30976.29685725104,2005,1051,954,41901.74563591022,49807.80209324453,33191.82389937107,3532,2500,1032,46245.38505096263,50405.44,36167.732558139534,1946,1291,655,26815.878725590956,30492.176607281177,19569.923664122136
92,Cattaraugus & Allegany Counties PUMA,0,0,0,#DIV/0!,0.0,0.0,0,0,0,#DIV/0!,0.0,0.0,0,0,0,#DIV/0!,0.0,0.0,0,0,0,#DIV/0!,0.0,0.0
93,Oswego County PUMA,0,0,0,#DIV/0!,0.0,0.0,0,0,0,#DIV/0!,0.0,0.0,0,0,0,#DIV/0!,0.0,0.0,0,0,0,#DIV/0!,0.0,0.0
94,"NYC-Queens Community District 5--Ridgewood, Glendale & Middle Village PUMA",7691,4699,2992,43030.56819659342,46846.35028729517,37037.800802139034,1521,667,854,66918.27744904668,83328.33583208396,54101.52224824356,4353,2343,2010,39055.50195267631,46242.509603072984,30677.81094527363,1817,1689,128,32557.402311502476,33276.968620485495,23062.5
95,Monroe County (East) PUMA,358,275,83,60047.486033519555,54025.454545454544,80000.0,83,0,83,80000.0,0.0,80000.0,275,275,0,54025.454545454544,54025.454545454544,0.0,0,0,0,#DIV/0!,0.0,0.0
96,Westchester County (South Central)--New Rochelle & Mount Vernon Cities PUMA,3492,2782,710,56357.78350515464,49290.79798705967,84048.42253521127,902,491,411,113197.42793791574,115562.52545824848,110371.9708029197,1542,1243,299,37441.82879377432,34934.67417538214,47864.548494983275,1048,1048,0,35269.083969465646,35269.083969465646,0.0
97,"NYC-Queens Community District 14--Far Rockaway, Breezy Point & Broad Channel PUMA",2592,1807,785,34546.06481481482,31169.56281128943,42318.47133757962,495,0,495,51292.92929292929,0.0,51292.92929292929,139,139,0,95000.0,95000.0,0.0,1958,1668,290,26020.633299284986,25850.359712230216,27000.0
98,"NYC-Brooklyn Community District 12--Borough Park, Kensington & Ocean Parkway PUMA",1822,1314,508,46578.1558726674,50328.31050228311,36877.95275590551,467,169,298,60205.56745182013,93502.95857988166,41322.147651006715,467,257,210,58588.86509635975,81482.49027237354,30571.428571428572,888,888,0,33095.045045045044,33095.045045045044,0.0
99,"NYC-Bronx Community District 10--Co-op City, Pelham Bay & Schuylerville PUMA",2720,826,1894,38277.64705882353,28202.421307506054,42671.594508975715,1248,0,1248,37793.269230769234,0.0,37793.269230769234,938,292,646,40547.97441364606,15000.0,52095.97523219814,534,534,0,35421.722846441946,35421.722846441946,0.0
100,"NYC-Queens Community District 11--Bayside, Douglaston & Little Neck PUMA",1778,1178,600,58867.26659167604,51250.424448217316,73821.66666666667,347,210,137,66334.2939481268,55800.0,82481.75182481752,1301,838,463,60844.73481936972,55090.692124105015,71259.17926565875,130,130,0,19146.153846153848,19146.153846153848,0.0
101,"NYC-Manhattan Community District 6--Murray Hill, Gramercy & Stuyvesant Town PUMA",2579,1991,588,125250.95773555641,131429.3420391763,104330.61224489796,2579,1991,588,125250.95773555641,131429.3420391763,104330.61224489796,0,0,0,#DIV/0!,0.0,0.0,0,0,0,#DIV/0!,0.0,0.0
102,Chautauqua County PUMA,210,179,31,19647.619047619046,16000.0,40709.67741935484,31,0,31,40709.67741935484,0.0,40709.67741935484,0,0,0,#DIV/0!,0.0,0.0,179,179,0,16000.0,16000.0,0.0
103,NYC-Brooklyn Community District 18--Canarsie & Flatlands PUMA,2896,1445,1451,36078.52209944752,42914.53287197232,29270.778773259823,1533,330,1203,41526.09262883235,85727.27272727272,29401.08063175395,1363,1115,248,29951.504035216436,30243.497757847534,28638.709677419356,0,0,0,#DIV/0!,0.0,0.0
104,Erie County (West Central)--Buffalo City (East) PUMA,379,308,71,26228.49604221636,28816.883116883117,15000.0,0,0,0,#DIV/0!,0.0,0.0,308,308,0,28816.883116883117,28816.883116883117,0.0,71,0,71,15000.0,0.0,15000.0
105,Genesee & Orleans Counties PUMA,305,305,0,20000.0,20000.0,0.0,0,0,0,#DIV/0!,0.0,0.0,0,0,0,#DIV/0!,0.0,0.0,305,305,0,20000.0,20000.0,0.0
106,"NYC-Staten Island Community District 1--Port Richmond, Stapleton & Mariner's Harbor PUMA",2559,1090,1469,36406.52598671356,28590.275229357798,42206.19469026549,453,70,383,82860.04415011038,41600.0,90401.04438642297,1817,824,993,27879.031370390752,30250.0,25911.581067472307,289,196,93,17205.882352941175,16966.326530612245,17710.752688172044
107,"Steuben (North & West), Schuyler & Chemung (North) Counties PUMA",79,79,0,34500.0,34500.0,0.0,0,0,0,#DIV/0!,0.0,0.0,79,79,0,34500.0,34500.0,0.0,0,0,0,#DIV/0!,0.0,0.0
108,Nassau County (South Central)--Hempstead Town (Southeast) PUMA,2576,1744,832,48876.125776397515,55094.55275229358,35841.346153846156,482,330,152,84394.60580912862,100964.24242424243,48421.05263157895,1192,807,385,42016.526845637585,42594.42379182156,40805.194805194806,902,607,295,38961.19733924612,46775.94728171334,22881.35593220339
109,"NYC-Bronx Community District 9--Castle Hill, Clason Point & Parkchester PUMA",6330,3265,3065,32073.191153238546,34599.08116385911,29382.47960848287,466,328,138,43066.523605150214,35942.07317073171,60000.0,4052,1599,2453,29692.694965449162,36079.7373358349,25529.27028128822,1812,1338,474,34569.26048565121,32500.373692077726,40409.28270042194
110,Suffolk County (East) PUMA,6864,5515,1349,46246.56614219114,49842.26654578422,31546.5752409192,1615,1564,51,63829.7213622291,65095.90792838875,25000.0,4359,3140,1219,35837.24019270475,38364.076433121016,29328.408531583264,890,811,79,65322.3595505618,64866.70776818742,70000.0
111,Orange County (Northwest) PUMA,1959,1655,304,42411.94486983155,45115.64954682779,27692.763157894737,0,0,0,#DIV/0!,0.0,0.0,1688,1441,247,43775.473933649286,46188.3414295628,29698.785425101214,271,214,57,33918.81918819188,37892.52336448598,19000.0
112,Broome County (West Central)--Greater Binghamton City & Greater Johnson City Village PUMA,137,0,137,32000.0,0.0,32000.0,0,0,0,#DIV/0!,0.0,0.0,137,0,137,32000.0,0.0,32000.0,0,0,0,#DIV/0!,0.0,0.0
113,"NYC-Bronx Community District 11--Pelham Parkway, Morris Park & Laconia PUMA",4601,2840,1761,31744.229515322757,31972.88732394366,31375.468483816014,1021,287,734,35126.346718903034,29704.52961672474,37246.321525885556,2391,1496,895,35088.66583019657,38233.95721925134,29831.28491620112,1189,1057,132,22114.550042052146,23727.341532639544,9200.0
114,Suffolk County (Northwest)--Smithtown Town PUMA,733,493,240,51307.23055934516,55499.797160243405,42695.0,398,158,240,57236.68341708543,79325.3164556962,42695.0,335,335,0,44262.68656716418,44262.68656716418,0.0,0,0,0,#DIV/0!,0.0,0.0
115,Ulster County (East) PUMA,810,492,318,54149.25925925926,47888.0081300813,63836.477987421385,349,68,281,66363.89684813753,72000.0,65000.0,210,210,0,38260.0,38260.0,0.0,251,214,37,50459.3625498008,49674.299065420564,55000.0
116,Westchester County (Northeast) PUMA,2136,1731,405,36520.36516853933,32360.196418255342,54301.234567901236,327,228,99,42091.74311926605,38377.19298245614,50646.46464646464,783,477,306,52932.31162196679,51295.59748427673,55483.660130718956,1026,1026,0,22219.785575048732,22219.785575048732,0.0
117,NYC-Brooklyn Community District 4--Bushwick PUMA,3979,2246,1733,34403.92058306107,30528.6731967943,39426.312752452395,1015,250,765,54117.24137931035,20000.0,65266.666666666664,2213,1543,670,27720.650700406688,30433.830200907323,21472.238805970148,751,453,298,27454.593874833554,36662.25165562914,13457.71812080537
118,NYC-Manhattan Community District 3--Chinatown & Lower East Side PUMA,2776,1480,1296,43571.57780979827,59483.51351351351,25400.54012345679,681,406,275,82740.08810572687,91940.88669950739,69156.36363636363,1565,876,689,30461.78913738019,46131.963470319635,10538.606676342526,530,198,332,31954.716981132075,52000.0,20000.0
119,Dutchess County (North & East) PUMA,1172,1068,104,39559.470989761096,39385.486891385764,41346.153846153844,131,71,60,29690.83969465649,34500.0,24000.0,948,904,44,42887.55274261603,41811.28318584071,65000.0,93,93,0,19535.483870967742,19535.483870967742,0.0
120,Nassau County (Central)--Hempstead Town (North Central)--Meadowbrook Corridor PUMA,5786,3686,2100,38874.07535430349,41389.01247965274,34459.76190476191,312,122,190,67977.56410256411,52000.0,78236.84210526316,3787,2253,1534,39330.05017163982,43664.89125610297,32963.42894393742,1687,1311,376,32467.99051570836,36490.38901601831,18443.08510638298
121,Broome (Outer West) & Tioga Counties PUMA,567,295,272,87504.40917107584,135915.25423728814,35000.0,426,154,272,98262.91079812206,210000.0,35000.0,141,141,0,55000.0,55000.0,0.0,0,0,0,#DIV/0!,0.0,0.0
122,"Rockland County (South)--Orangetown, Clarkstown (South) & Ramapo (Southeast) Towns PUMA",2381,1782,599,48037.16925661487,42665.82491582492,64016.69449081803,882,393,489,75879.8185941043,80000.0,72568.5071574642,894,784,110,35143.17673378076,36426.02040816326,26000.0,605,605,0,26500.0,26500.0,0.0
123,"NYC-Brooklyn Community District 17--East Flatbush, Farragut & Rugby PUMA",597,250,347,48806.36515912898,62000.0,39300.864553314124,62,0,62,58000.0,0.0,58000.0,215,0,215,31727.441860465115,0.0,31727.441860465115,320,250,70,58500.0,62000.0,46000.0
124,Orange County (Northeast)--Greater Newburgh City PUMA,2277,1230,1047,36272.068511198944,36615.20325203252,35868.95893027698,116,0,116,65000.0,0.0,65000.0,1501,825,676,37053.96402398401,38143.27272727273,35724.55621301775,660,405,255,29444.696969696968,33502.46913580247,23000.0
125,"NYC-Manhattan Community District 1 & 2--Battery Park City, Greenwich Village & Soho PUMA",1534,947,587,183912.64667535853,165508.9757127772,213603.066439523,1456,869,587,188407.96703296702,171388.95281933257,213603.066439523,78,78,0,100000.0,100000.0,0.0,0,0,0,#DIV/0!,0.0,0.0
126,NYC-Queens Community District 6--Forest Hills & Rego Park PUMA,3893,2682,1211,66319.21397379912,65853.05741983594,67351.61023947151,1301,958,343,85176.40276710223,74042.48434237996,116273.4693877551,2592,1724,868,56854.24382716049,61302.32018561485,48019.58525345622,0,0,0,#DIV/0!,0.0,0.0
127,Onondaga County (North) PUMA,260,0,260,45000.0,0.0,45000.0,260,0,260,45000.0,0.0,45000.0,0,0,0,#DIV/0!,0.0,0.0,0,0,0,#DIV/0!,0.0,0.0
128,Nassau County (Northeast)--Oyster Bay Town (North) & Glen Cove City PUMA,1785,1147,638,40782.072829131655,44387.96861377507,34299.373040752354,717,572,145,62944.90934449094,58464.16083916084,80620.68965517242,993,500,493,27836.858006042297,34898.0,20675.456389452334,75,75,0,300.0,300.0,0.0
129,Monroe County (North & West) PUMA,79,79,0,201000.0,201000.0,0.0,79,79,0,201000.0,201000.0,0.0,0,0,0,#DIV/0!,0.0,0.0,0,0,0,#DIV/0!,0.0,0.0
130,Sullivan & Ulster (West) Counties PUMA,1005,837,168,42216.91542288557,43713.261648745516,34761.90476190476,54,0,54,65000.0,0.0,65000.0,373,259,114,52107.23860589812,66046.33204633204,20438.59649122807,578,578,0,33705.882352941175,33705.882352941175,0.0
131,Suffolk County (Southwest)--Babylon Town (Southeast) PUMA,1167,673,494,41231.619537275066,53407.132243684995,24644.331983805667,0,0,0,#DIV/0!,0.0,0.0,809,673,136,50312.731767614336,53407.132243684995,35000.0,358,0,358,20710.335195530726,0.0,20710.335195530726
132,Suffolk County (Northwest)--Huntington Town (North) PUMA,2926,1986,940,38869.706083390294,41922.638469285,32419.574468085106,661,458,203,72810.89258698942,96218.3406113537,20000.0,1407,734,673,33765.14570007107,32486.59400544959,35159.58395245171,858,794,64,21092.30769230769,19326.448362720403,43000.0
133,"NYC-Queens Community District 12--Jamaica, Hollis & St. Albans PUMA",6111,3615,2496,29576.255931926036,32916.23789764869,24738.902243589742,706,167,539,46623.93767705382,94377.24550898203,31828.38589981447,2797,1827,970,31906.900250268143,32090.749863163655,31560.618556701033,2608,1621,987,22461.80981595092,27514.743985194324,14163.120567375887
134,"NYC-Queens Community District 13--Queens Village, Cambria Heights & Rosedale PUMA",2641,1697,944,53321.35554714123,57512.55156157926,45786.970338983054,1032,812,220,61186.82170542636,65232.512315270935,46254.545454545456,1562,838,724,48826.4404609475,51575.178997613366,45644.88950276243,47,47,0,30000.0,30000.0,0.0
135,Monroe County (Central)--Rochester City (West) PUMA,214,0,214,20000.0,0.0,20000.0,0,0,0,#DIV/0!,0.0,0.0,0,0,0,#DIV/0!,0.0,0.0,214,0,214,20000.0,0.0,20000.0
136,NYC-Queens Community District 10--Howard Beach & Ozone Park PUMA,5703,2673,3030,36199.47396107312,38473.887018331465,34193.03630363036,1483,460,1023,51296.156439649356,59361.95652173913,47669.30596285435,3204,1548,1656,30980.71161048689,34590.43927648579,27606.400966183573,1016,665,351,30621.259842519685,33064.96240601504,25991.452991452992
137,Suffolk County (Central)--Islip Town (Northwest) PUMA,10452,7525,2927,47798.824148488326,51225.782059800666,38988.48650495388,885,624,261,67622.49717514124,73911.71474358975,52586.206896551725,5803,3939,1864,43245.390315354125,43479.48717948718,42750.69742489271,3764,2962,802,50157.91710945802,56747.94058068872,25819.20199501247
138,Putnam County PUMA,1727,1237,490,36193.97799652577,38292.48181083266,30896.326530612245,583,279,304,32260.72041166381,36903.22580645161,28000.0,880,694,186,34470.681818181816,34159.942363112394,35630.10752688172,264,264,0,50624.242424242424,50624.242424242424,0.0
139,NYC-Queens Community District 2--Sunnyside & Woodside PUMA,5709,3342,2367,37440.572779821334,36728.0460801915,38446.59907055344,1030,393,637,65917.28155339806,65691.60305343512,66056.51491365777,3680,2132,1548,31165.02445652174,32727.387429643528,29013.242894056846,999,817,182,31197.337337337336,33235.667074663404,22047.252747252747
140,Nassau County (Central)--Hempstead Town (East Central) PUMA,842,449,393,64041.44893111639,46729.17594654788,83820.6106870229,595,306,289,83355.46218487395,66323.5294117647,101389.27335640139,143,143,0,4800.0,4800.0,0.0,104,0,104,35000.0,0.0,35000.0
141,Suffolk County (Northwest)--Huntington Town (South) PUMA,626,140,486,53987.220447284344,14400.0,65390.94650205761,302,0,302,90000.0,0.0,90000.0,184,0,184,25000.0,0.0,25000.0,140,140,0,14400.0,14400.0,0.0
142,"NYC-Bronx Community District 4--Concourse, Highbridge & Mount Eden PUMA",7906,4275,3631,32483.936250948645,33446.22222222222,31350.977692095843,1522,879,643,45832.720105124834,50602.27531285552,39312.59720062208,4425,2265,2160,32546.12429378531,32049.97792494481,33066.38888888889,1959,1131,828,21972.434915773352,22908.93015030946,20693.236714975847
143,Nassau County (Central)--Hempstead Town (Northeast) PUMA,3477,3089,388,49863.963186655164,49096.47134995144,55974.22680412371,152,0,152,80000.0,0.0,80000.0,1485,1249,236,56202.6936026936,59169.735788630904,40500.0,1840,1840,0,42258.69565217391,42258.69565217391,0.0
144,NYC-Brooklyn Community District 14--Flatbush & Midwood PUMA,2097,1125,972,42735.52694325226,63806.044444444444,18348.353909465022,417,417,0,125335.7314148681,125335.7314148681,0.0,1107,202,905,15357.181571815718,10000.0,16552.92817679558,573,506,67,35516.57940663176,34578.656126482216,42600.0
145,"Rockland County (West)--Spring Valley, Suffern Villages & Monsey PUMA",1322,928,394,32355.068078668683,26615.30172413793,45874.1116751269,67,67,0,58447.76119402985,58447.76119402985,0.0,814,420,394,40048.402948402945,34583.333333333336,45874.1116751269,441,441,0,14190.47619047619,14190.47619047619,0.0
146,Capital Region,3097,1539,1558,549262.5466997409,548435.4887103289,319465.7818532819,1099,536,563,#DIV/0!,208701.26176497995,222360.43956043955,1394,632,762,#DIV/0!,360853.24074074073,110812.5,604,371,233,#DIV/0!,78400.0,52000.0
147,Central NY,1850,1180,670,#DIV/0!,151679.9435365303,188672.48908296943,776,335,441,#DIV/0!,84800.0,146000.0,1000,771,229,#DIV/0!,179996.4349376114,42672.489082969434,74,74,0,#DIV/0!,93600.0,0.0
148,Finger Lakes,2900,2003,897,#DIV/0!,416536.5824538781,202039.0,256,79,177,#DIV/0!,201000.0,138000.0,1231,1013,218,#DIV/0!,142310.45213116193,35112.08791208791,1413,911,502,#DIV/0!,150365.8263305322,73724.96402877697
149,Long Island,67024,45632,21392,1267287.1478821589,1375591.9338272398,1158563.7073415287,9945,6165,3780,#DIV/0!,1761330.9573855987,1398756.37330773,38399,26106,12293,1070466.5165316418,1168860.0788397994,777475.7573527177,18680,13361,5319,#DIV/0!,623561.6255613774,477900.7944900296
150,Mid-Hudson,51863,36714,15149,739374.0377906587,730884.5805363441,780838.0395592054,9998,4063,5935,#DIV/0!,959402.7123835734,799849.1479496781,27995,19859,8136,716962.1775532638,736572.9476353592,629499.7671585511,13870,12792,1078,#DIV/0!,523890.71655680914,194435.89743589744
151,Mohawk Valley,306,114,192,#DIV/0!,62000.0,30263.069518716577,54,0,54,#DIV/0!,0.0,37100.0,138,0,138,#DIV/0!,0.0,41672.061068702285,114,114,0,#DIV/0!,62000.0,0.0
152,New York City,255948,151886,104062,2660818.391514169,2804232.203585425,2439194.9712954084,60898,28440,32458,#DIV/0!,3432169.460261504,2909258.033932901,140690,81336,59354,#DIV/0!,2147956.4830372487,1669912.7058167164,54360,42110,12250,#DIV/0!,1365810.7149637232,660004.4751819974
153,North Country,970,948,22,164002.8208744711,165251.8195050946,26000.0,587,565,22,#DIV/0!,157000.0,26000.0,383,383,0,#DIV/0!,42000.0,0.0,0,0,0,#DIV/0!,0.0,0.0
154,Southern Tier,939,530,409,244004.40917107585,260415.25423728814,67000.0,426,154,272,#DIV/0!,210000.0,35000.0,461,324,137,#DIV/0!,134500.0,32000.0,52,52,0,#DIV/0!,45000.0,0.0
155,Western NY,3268,1770,1498,#DIV/0!,290850.0760453042,205570.10544919467,1461,515,946,#DIV/0!,109503.2258064516,222406.55155823607,1376,1076,300,#DIV/0!,190409.44717005204,81100.0,431,179,252,#DIV/0!,16000.0,33497.23756906077
