,puma,Total_geo,Total_geo_m,Total_geo_f,Total_Avg_PINCP_mf_t,Total_Avg_PINCP_m,Total_Avg_PINCP_f,Total_BABS,Total_BABS_m,Total_BABS_f,BABS_Avg_PINCP_mf_t,BABS_Avg_PINCP_m,BABS_Avg_PINCP_f,Total_HS,Total_HS_m,Total_HS_f,HS_Avg_PINCP_mf_t,HS_Avg_PINCP_m,HS_Avg_PINCP_f,Total_HSINC,Total_HSINC_m,Total_HSINC_f,HSINC_Avg_PINCP_mf_t,HSINC_Avg_PINCP_m,HSINC_Avg_PINCP_f
0,Total Geo,4778226,2588175,2190051,80952.6859985275,91269.09616312652,68760.88093199657,2357248,1143271,1213977,108586.46511949527,130810.89375484902,87656.46006143444,2245664,1327452,918212,55149.34563140345,61568.13438678009,45869.752279430024,175314,117452,57862,39917.526096033405,42054.18826414195,35580.39213991912
1,"NYC-Manhattan Community District 9--Hamilton Heights, Manhattanville & West Harlem PUMA",26257,13558,12699,73075.00856914347,81262.1522348429,64334.06094968108,17284,8002,9282,81231.87051608424,90576.03849037741,73176.27558715794,8575,5297,3278,58557.30029154519,69182.14083443458,41388.36180597926,398,259,139,31633.165829145728,40559.84555984556,15000.0
2,Ulster County (East) PUMA,45595,25528,20067,66904.4430310341,73207.49647445942,58886.087108187574,15402,6842,8560,86678.48980651863,98914.4913767904,76898.26518691589,28187,17261,10926,58251.48756518963,65965.628874341,46064.61285008237,2006,1425,581,36665.65304087737,37498.45614035088,34623.063683304645
3,Albany County (East Central)--Albany City PUMA,24909,13721,11188,58122.8684411257,65696.16354493113,48834.95441544512,13251,6712,6539,74296.50516942117,86642.17520858164,61624.21012387215,10975,6484,4491,40661.09703872437,47055.95003084516,31428.358940102426,683,525,158,24925.32942898975,28121.904761904763,14303.79746835443
4,Chemung (South) & Steuben (East) Counties--Greater Elmira & Greater Corning Cities PUMA,30431,15879,14552,61292.368637244916,67678.2946029347,54324.10871357889,10701,5886,4815,90414.6958228203,103716.9367991845,74153.6386292835,19201,9648,9553,43303.62012395188,46721.40858208955,39851.843399979065,529,345,184,125118.33648393194,38891.59420289855,286793.47826086957
5,Ontario & Yates Counties PUMA,44472,23323,21149,66257.15821190862,71632.05162286156,60329.75554399735,18103,7586,10517,92086.46798873115,104353.81624044292,83237.9271655415,24365,14034,10331,48324.74533141802,55977.96066695169,37928.34381957216,2004,1703,301,50955.384231536926,54874.685848502646,28780.730897009966
6,Suffolk County (North Central)--Brookhaven Town (North) PUMA,30260,17530,12730,95295.04461335095,108567.0958357102,77018.60644147683,14428,6952,7476,112850.46090934295,138574.5238780207,88929.42215088282,15409,10155,5254,79687.55921863846,89837.03594288528,60070.51770079939,423,423,0,65049.645390070924,65049.645390070924,0.0
7,Westchester County (South Central)--New Rochelle & Mount Vernon Cities PUMA,41154,22469,18685,108654.45788987704,129610.28038631003,83454.75889751138,22528,11631,10897,157025.5419921875,199428.08356977045,111766.85050931449,17652,10041,7611,50928.54350781781,55868.12568469276,44411.877545657604,974,797,177,36040.5544147844,39765.99749058971,19265.53672316384
8,"Clinton, Franklin, Essex & Hamilton Counties PUMA",51031,29186,21845,56985.25935215849,60098.360515315566,52826.002288853284,15917,6403,9514,80016.69284412892,93996.79993752929,70607.96615513979,33028,21088,11940,47491.58199103791,52627.57207890743,38420.58040201005,2086,1695,391,31561.409395973154,24990.5604719764,60046.291560102305
9,Oneida County (Central)--Greater Utica & Rome Cities PUMA,42248,24291,17957,56276.120763113046,59976.016219999176,51271.15553823022,14527,7867,6660,85304.72017622358,95785.1951188509,72924.85585585586,25961,15176,10785,41591.397095643464,43509.47944122298,38892.38757533611,1760,1248,512,33282.73863636364,34483.50961538462,30355.859375
10,"NYC-Bronx Community District 3 & 6--Belmont, Crotona Park East & East Tremont PUMA",22264,9087,13177,48158.43738771111,51243.193573236495,46031.1565606739,4829,1799,3030,73084.57237523296,80438.02112284602,68718.61386138614,15117,6373,8744,44343.43123635642,47174.595951671115,42279.9576852699,2318,915,1403,21110.612597066436,22180.546448087433,20412.829650748397
11,Livingston & Wyoming Counties PUMA,32598,18602,13996,53897.46487514571,60096.390173099666,45658.5102886539,8282,3788,4494,67702.76503260082,74334.3268215417,62113.01068090788,23401,14271,9130,49853.825050211526,57169.723214911355,38418.42716319825,915,543,372,32356.17486338798,37689.68692449355,24570.967741935485
12,NYC-Manhattan Community District 3--Chinatown & Lower East Side PUMA,40849,18222,22627,97963.41917794805,111383.56766545934,87155.89074998895,33022,14761,18261,110101.76912361456,125901.2553350044,97330.49613931328,7267,2999,4268,48920.111462776935,54656.31877292431,44889.44470477976,560,462,98,18615.428571428572,15776.277056277057,32000.0
13,Suffolk County (West Central)--Babylon Town (Northwest) PUMA,26094,13776,12318,67378.71694642447,75975.44279907085,57764.45364507225,10982,3986,6996,82563.68603168822,105718.86603110888,69370.92624356775,13882,9224,4658,57731.39605244201,63602.80789245447,46104.53842851009,1230,566,664,40681.78861788618,68144.87632508833,17271.98795180723
14,Broome County (West Central)--Greater Binghamton City & Greater Johnson City Village PUMA,30188,15213,14975,52488.35199416987,59368.63603497009,45498.718530884806,11253,5748,5505,74767.15720252377,82170.15135699374,67037.38237965485,17849,9172,8677,39903.66687209367,46048.10619276058,33408.703468940876,1086,293,793,28474.217311233886,29036.860068259386,28266.330390920553
15,Nassau County (Northwest)--North Hempstead Town (North) PUMA,24108,13947,10161,177709.57648913225,229094.72646447265,107178.26198208837,19281,10987,8294,202050.2733260723,266207.1065805042,117062.19435736677,4584,2829,1755,81953.43586387434,94523.17780134323,61691.441595441596,243,131,112,52743.20987654321,22600.0,88000.0
16,Monroe County (Central)--Rochester City (East) PUMA,28823,14370,14453,54224.44818374215,62247.81141266527,46247.16114301529,13812,6774,7038,68069.97103967564,77271.48361381753,59213.61324239841,12587,6650,5937,43875.13069039485,50402.27067669173,36564.11824153613,2424,946,1478,29072.838283828383,37937.54756871036,23398.94451962111
17,Westchester County (Northwest) PUMA,37016,20640,16376,113461.5725632159,128593.62354651163,94389.42232535417,23188,11233,11955,140050.46791443852,173742.75883557377,108392.96026767044,12975,8839,4136,69245.45818882466,75633.72327186333,55593.16731141199,853,568,285,63239.74208675264,59847.711267605635,70000.0
18,NYC-Brooklyn Community District 16--Brownsville & Ocean Hill PUMA,19807,7047,12760,53289.686474478716,61552.40527884206,48726.41222570533,5148,1262,3886,70253.23232323233,73094.80190174327,69330.41688111168,12843,4853,7990,48852.18406914272,60711.477436637135,41649.03629536921,1816,932,884,36584.01982378855,50301.888412017164,22121.289592760182
19,Onondaga County (Central)--Syracuse City PUMA,29515,16657,12858,47757.16347619854,48251.81365191811,47116.364909006064,10066,4845,5221,63039.55692429962,66880.96181630547,59474.79793143076,17108,10213,6895,41991.191255552956,43153.05982571233,40270.210297316895,2341,1599,742,24182.486117043998,24371.482176360227,23775.20215633423
20,Westchester County (Northeast) PUMA,35955,22237,13718,172766.7676261994,203772.43153303053,122506.31068668902,27138,15704,11434,194044.42405483086,241624.43071828832,128695.7775056848,8588,6304,2284,109289.11853749419,115726.66560913705,91521.03765323992,229,229,0,31775.545851528383,31775.545851528383,0.0
21,Madison & Cortland Counties PUMA,37462,20217,17245,55014.104692755325,58099.48904387397,51396.985792983476,11432,4800,6632,72701.12753673898,83035.94166666667,65221.165560916765,23580,13335,10245,46180.16115351993,48514.896887889015,43141.24450951684,2450,2082,368,57506.489795918365,61997.45437079731,32098.369565217392
22,Erie County (West Central)--Buffalo City (West) PUMA,31909,16109,15800,59186.75953492745,67308.3102613446,50906.37594936709,17965,7815,10150,75022.18703033676,96246.80230326296,58680.27881773399,12766,7507,5259,39747.561491461696,41263.28226988144,37583.93420802434,1178,787,391,28352.589134125636,28382.909783989835,28291.56010230179
23,Monroe County (Central)--Rochester City (West) PUMA,20381,9472,10909,39380.697708650216,39659.68855574324,39138.457237143644,6016,2829,3187,56542.01628989362,59234.70130788264,54151.80420458111,12857,5653,7204,32861.86746519406,32094.038563594553,33464.38506385341,1508,990,518,26496.153846153848,26923.23232323232,25679.92277992278
24,Suffolk County (Central)--Islip Town (East) PUMA,35561,19740,15821,81433.92564888501,94562.37841945289,65053.44036407307,17167,7568,9599,84703.38498281587,98636.3768498943,73718.39879154079,18138,12049,6089,78894.85169257912,92438.4803718151,52094.52619477747,256,123,133,42085.9375,51951.21951219512,32962.406015037595
25,Nassau County (Central)--Hempstead Town (East Central) PUMA,29677,17000,12677,110793.63716009031,126267.38529411764,90043.16636428177,19985,10797,9188,121536.3507630723,138154.2419190516,102008.3391380061,9181,5877,3304,89339.81047816142,106012.28517951336,59683.59564164649,511,326,185,76105.67514677104,97730.06134969325,38000.0
26,"NYC-Bronx Community District 5--Morris Heights, Fordham South & Mount Hope PUMA",11566,6144,5422,53495.35708109978,45369.205729166664,62703.59645887127,3171,1418,1753,84397.26269315674,51698.095909732016,110847.58699372504,7342,4069,3273,41569.96458730591,42847.11231260752,39982.21203788573,1053,657,396,43586.79962013295,47329.6803652968,37377.020202020205
27,St. Lawrence County PUMA,32291,18185,14106,54126.51884426001,57988.18421776189,49148.18446051326,9193,3951,5242,77541.93408027847,88480.5973171349,69297.24532621137,21937,13491,8446,45945.35807083922,50876.90237936402,38068.083116268055,1161,743,418,23301.5503875969,24963.660834454913,20347.12918660287
28,Columbia & Greene Counties PUMA,32862,17324,15538,62679.461140527055,61656.76056338028,63819.715021238255,12004,4920,7084,88706.93118960346,97917.91666666667,82309.69113495201,20232,11915,8317,47865.89808224595,47458.62945866555,48449.35433449561,626,489,137,42350.798722044725,42773.00613496933,40843.79562043796
29,NYC-Brooklyn Community District 2--Brooklyn Heights & Fort Greene PUMA,51021,25886,25135,131849.92395288215,157299.27953333847,105640.1758504078,44187,21657,22530,141810.8751442732,172733.53419217805,112086.4176653351,5913,3919,1994,63353.429731100965,68438.12196989027,53359.994984954865,921,310,611,93712.26927252985,202419.35483870967,38558.10147299509
30,"NYC-Queens Community District 8--Briarwood, Fresh Meadows & Hillcrest PUMA",21124,11382,9742,69046.71037682256,75694.9446494465,61279.29070006159,12159,6168,5991,81645.29977794226,93672.84370946822,69262.4102820898,8580,4923,3657,52702.04079254079,55161.84440381881,49390.68908941755,385,291,94,35412.98701298701,42006.872852233675,15000.0
31,Monroe County (North & West) PUMA,38363,20919,17444,64846.967390454345,68108.23653138295,60936.02442100436,17069,7960,9109,80943.043529205,86522.6407035176,76067.25107036997,20578,12518,8060,51625.546700359606,56508.705863556475,44041.503722084366,716,441,275,61112.98882681564,64988.662131519275,54897.818181818184
32,Schenectady County--Schenectady City PUMA,48532,25883,22649,62301.286573806974,68575.52138469265,55131.167821978896,19618,8669,10949,82302.41359975532,94375.11823739762,72743.70718787104,25919,15957,9962,50563.142482348856,56686.778216456725,40754.38365790002,2995,1257,1738,32871.8530884808,41568.33731105807,26582.16340621404
33,"Rockland County (West)--Spring Valley, Suffern Villages & Monsey PUMA",13891,8981,4910,78444.74047944712,85452.33270237167,65626.98370672097,5865,3493,2372,101561.91133844842,111791.55453764672,86497.76981450254,7069,4531,2538,60663.23100862923,68808.78393290665,46121.268715524035,957,957,0,68115.8829676071,68115.8829676071,0.0
34,Niagara County (North & East) PUMA,35540,19214,16326,60063.2315700619,64732.46226709691,54568.03381109886,11874,5383,6491,77546.4586491494,86121.31153631804,70435.31505160993,22656,13419,9237,51270.04325564972,56989.12064982487,42961.68561221176,1010,412,598,51768.81188118812,37479.36893203884,61613.71237458194
35,Suffolk County (Central)--Brookhaven Town (Central) PUMA,44232,22488,21744,72219.20690902515,79198.14567769477,65001.47442972774,15858,6768,9090,84914.182116282,80489.31737588653,88208.73487348735,27702,15472,12230,65141.955815464586,78238.83143743536,48573.283728536386,672,248,424,64387.5,103810.48387096774,41328.77358490566
36,Suffolk County (East) PUMA,34020,20923,13097,105910.83450911229,115819.3629020695,90081.54997327633,18919,10372,8547,132530.3308842962,152229.69436945624,108624.6566046566,14329,9871,4458,74951.79426338195,83577.4632762638,55852.65141318977,772,680,92,28187.82383419689,28483.823529411766,26000.0
37,Warren & Washington Counties PUMA,40049,21417,18632,56362.73714699493,56580.35392445254,56112.59231429798,13292,6315,6977,78191.47457117063,72238.58749010293,83579.53275046582,25153,13795,11358,46478.888402973804,51876.278361725264,39923.421377003,1604,1307,297,30465.52369077307,30574.98087222647,29983.838383838385
38,NYC-Queens Community District 6--Forest Hills & Rego Park PUMA,20844,11042,9802,85849.38015735944,88216.47527621807,83182.83615588656,14834,7726,7108,97199.85978158285,100123.62930365001,94021.8851997749,5525,3008,2517,60228.807239819005,62916.742021276594,57016.52761223679,485,308,177,30551.75257731959,36615.58441558442,20000.0
39,"NYC-Brooklyn Community District 9--Crown Heights South, Prospect Lefferts & Wingate PUMA",23615,12330,11285,70777.36523396146,77260.06812652068,63694.35888347364,15235,7865,7370,86352.41089596324,93027.60839160839,79228.87924016282,7613,4082,3531,43642.46683304873,51410.11758941695,34662.70178419711,767,383,384,30741.069100391134,28977.545691906005,32500.0
40,Westchester County (Central)--White Plains City PUMA,39389,21876,17513,148526.08190103836,186011.1492046078,101702.38908239594,29245,16097,13148,169427.2183279193,209280.37771013234,120635.28749619714,10111,5746,4365,88533.26871723865,121851.4966933519,44673.809851088205,33,33,0,7120.0,7120.0,0.0
41,"NYC-Bronx Community District 1 & 2--Hunts Point, Longwood & Melrose PUMA",19833,9324,10509,43120.452780719,48490.11583011583,38356.27557331811,5305,2649,2656,63907.80395852969,77551.26462816157,50300.301204819276,11980,5193,6787,38161.29716193656,39797.71615636434,36909.20878149403,2548,1482,1066,23157.26059654631,27003.37381916329,17810.225140712944
42,Erie County (North Central) PUMA,37011,18560,18451,73096.24517035476,77709.6109913793,68455.62571134356,24389,11795,12594,84500.95001845094,89063.38448495125,80227.96966809592,12392,6651,5741,51561.28631375081,58529.508344609836,43488.53858212855,230,114,116,24017.391304347828,22000.0,26000.0
43,Chautauqua County PUMA,37523,21680,15843,49850.32273538896,54152.9557195572,43962.4805907972,10807,4560,6247,72689.54936615156,94941.94956140351,56446.4014727069,24474,15390,9084,40987.841791288716,44017.47108512021,35855.08146191105,2242,1730,512,36503.68421052631,36804.57225433526,35487.01171875
44,Dutchess County (Southwest) PUMA,47058,26621,20437,71010.67363678865,74206.86337853574,66847.35381905368,18500,8415,10085,98338.0454054054,113458.9376114082,85721.05899851264,27133,17400,9733,53877.92135038514,56319.53735632184,49512.96517004007,1425,806,619,42453.89473684211,50550.86848635236,31910.823909531504
45,Westchester County (Southeast) PUMA,25078,15203,9875,180973.0704202887,212707.12951391173,132117.0805063291,19208,11539,7669,213046.33277800915,258125.69893404975,145218.60998826445,5503,3452,2051,78087.57041613666,70984.71900347625,90042.24768405657,367,212,155,45048.50136239782,48277.35849056604,40632.25806451613
46,Rockland County (North)--New City & Congers PUMA,24269,14348,9921,86203.88932382876,91068.52732088095,79168.52736619292,12816,6430,6386,109614.99063670413,126049.8164852255,93066.92765424366,10376,6841,3535,61025.006746337705,64623.579885981584,54060.97878359265,1077,1077,0,50195.91457753017,50195.91457753017,0.0
47,NYC-Staten Island Community District 2--New Springville & South Beach PUMA,25820,13622,12198,75042.02323780015,86756.3309352518,61960.1819970487,11135,6560,4575,86782.74090704984,95189.04573170732,74729.11038251367,13749,6423,7326,67045.25565495672,81876.63085785459,54041.990171990175,936,639,297,52835.470085470086,49234.74178403756,60582.49158249158
48,Suffolk County (Southwest)--Islip Town (South) PUMA,31024,17366,13658,93664.5048994327,110144.8157318899,72709.96705227705,15284,7169,8115,109999.9064381052,144354.14562700517,79650.48675292668,15553,10120,5433,78010.67511091108,86216.60079051384,62725.57150745444,187,77,110,60475.935828877,69974.02597402598,53827.27272727273
49,Erie County (West Central)--Buffalo City (East) PUMA,33940,18163,15777,41883.63081909252,44533.442162638334,38833.08106737656,8029,3823,4206,57463.122431186945,59715.22626209783,55416.09605325725,23617,12754,10863,37857.586484312145,41985.61235690764,33010.96566326061,2294,1586,708,28804.010462074977,28426.923076923078,29648.728813559323
50,Wayne & Seneca Counties PUMA,41290,24866,16424,56560.30636958101,59581.032333306524,51986.91548952752,10006,5009,4997,86236.17229662203,93997.96366540228,78455.74144486692,28869,17927,10942,47238.92271987253,51222.83706141574,40711.81319685615,2415,1930,485,45033.31262939959,47893.44559585492,33651.75257731959
51,Monroe County (South) PUMA,48523,26514,22009,79613.93277414834,87415.11578788565,70215.93348175746,31327,15845,15482,93311.43007629202,108094.21836541496,78182.03591267279,16286,10055,6231,56405.91858037579,59064.534062655395,52115.69571497352,910,614,296,23420.76923076923,18041.693811074918,34578.71621621621
52,Tompkins County PUMA,27409,13618,13791,71466.44167974024,73964.96548685564,68999.26038720905,16687,7342,9345,79484.33511116439,72516.38790520294,84958.77795612627,9949,5614,4335,61220.55482963112,80924.50659066619,35703.14186851211,773,662,111,30252.652005174645,31011.17824773414,25728.828828828828
53,Suffolk County (South Central)--Brookhaven Town (South) PUMA,40563,23573,16990,70796.3678721988,77168.94667628218,61954.64920541495,13300,5518,7782,92350.68796992481,107922.40848133381,81309.2135697764,24700,15790,8910,62046.63643724696,70737.99430019,46644.10662177329,2563,2265,298,43268.43542723371,47079.38189845475,14302.68456375839
54,"Otsego, Schoharie, Oneida (South) & Herkimer (South) Counties PUMA",34958,19384,15574,54148.22158018193,58555.2233801073,48663.097470142544,10842,5166,5676,71605.88360081166,78350.02903600465,65467.71317829457,22025,12526,9499,47770.780476730986,53998.954175315346,39557.90504263607,2091,1692,399,30803.969392635103,31848.286052009455,26375.43859649123
55,NYC-Manhattan Community District 8--Upper East Side PUMA,68734,31715,37019,157286.51206098875,198838.2516159546,121688.2133499014,63689,29332,34357,162620.29816765847,206591.06436656212,125080.62607328928,4785,2234,2551,92016.49947753396,107639.2345568487,78335.12348098785,260,149,111,51953.846153846156,40000.0,68000.0
56,"NYC-Manhattan Community District 1 & 2--Battery Park City, Greenwich Village & Soho PUMA",56935,30063,26872,187025.11987354,233198.21075740943,135369.06036022626,52595,27045,25550,191900.558988497,244748.22739877983,135960.62974559687,3877,2787,1090,133158.4472530307,128113.38356655903,146058.0733944954,463,231,232,84254.8596112311,148787.87878787878,20000.0
57,"NYC-Manhattan Community District 12--Washington Heights, Inwood & Marble Hill PUMA",37937,20173,17764,59680.69299101141,61233.590938382986,57917.2044584553,22848,10252,12596,71334.89714635855,78449.13285212641,65544.55541441728,12768,8234,4534,45291.84837092732,47988.987126548454,40393.69210410234,2321,1687,634,24110.469625161568,21258.68405453468,31698.738170347002
58,NYC-Brooklyn Community District 18--Canarsie & Flatlands PUMA,29381,14034,15347,62602.111228344846,62055.36767849508,63102.07858213332,14042,4910,9132,75293.41048283721,70293.55804480652,77981.67980727114,14455,8533,5922,51153.4320304393,57831.437946794795,41531.10435663627,884,591,293,48212.33031674208,54598.9847715736,35330.03412969283
59,"NYC-Bronx Community District 12--Wakefield, Williamsbridge & Woodlawn PUMA",18479,9087,9392,51332.364305427785,50541.37339055794,52097.668228279384,6297,3101,3196,64118.61203747817,61026.79780715898,67118.52315394243,10354,5173,5181,46180.0328375507,45290.520007732455,47068.172167535224,1828,813,1015,36470.35010940919,43957.56457564576,30473.20197044335
60,Suffolk County (Central)--Islip Town (Northwest) PUMA,20316,11658,8658,57194.96771017917,62378.456338994685,50215.39847539848,6754,3450,3304,58309.84364820847,63377.23014492753,53018.53510895884,11351,6450,4901,59898.38604528236,69518.66666666667,47237.53927769843,2211,1758,453,39910.31207598372,34221.387940841865,61987.8587196468
61,"NYC-Queens Community District 14--Far Rockaway, Breezy Point & Broad Channel PUMA",22118,10988,11130,77013.25300660096,85286.42883145249,68845.6289308176,11033,4567,6466,95345.75183540289,125497.76220713816,74049.0875347974,9281,5543,3738,64451.82092446934,59379.37939743821,71973.63563402889,1804,878,926,29518.90243902439,39680.068337129844,19884.449244060474
62,Saratoga County (South & Central) PUMA,40426,21754,18672,70890.478899718,77585.41371701757,63090.47825621251,20751,10601,10150,90190.65394438822,102198.12376190926,77649.65024630542,18481,10619,7862,51124.221633028515,55124.75562670684,45720.80386670058,1194,534,660,41411.64154103852,35619.85018726592,46097.72727272727
63,Cattaraugus & Allegany Counties PUMA,36003,20257,15746,47645.80451629031,52026.80456138619,42009.711672805795,8700,4138,4562,56190.972413793104,58306.71822136298,54271.86760192898,25223,14245,10978,44745.07949094081,51113.81396981397,36481.04026234287,2080,1874,206,47079.471153846156,45100.053361792954,65086.40776699029
64,Genesee & Orleans Counties PUMA,33249,19308,13941,53733.960720623174,56849.95753055728,49418.3688401119,6744,2759,3985,78022.78766310794,83480.0579920261,74244.46675031367,25508,15676,9832,47697.789713031205,53021.784894105636,39209.28803905614,997,873,124,43871.173520561686,41429.55326460481,61060.967741935485
65,Cayuga & Onondaga (South) Counties PUMA,34285,18986,15299,64048.590637304944,75335.20436110819,50041.946532453105,12059,5783,6276,89117.34057550377,116784.47864430226,63623.54525175271,20842,12570,8272,51388.076959984646,58797.98170246619,40128.10323984526,1384,633,751,36278.62716763006,25053.58609794629,45739.94673768309
66,Sullivan & Ulster (West) Counties PUMA,28533,15311,13222,58279.713314407876,64049.061459081706,51598.841325064284,9203,4540,4663,85216.54134521351,90978.93832599118,79606.14411323183,17686,9442,8244,45436.058464322065,53056.42872272823,36708.3127122756,1644,1329,315,45660.03649635037,50151.99398043642,26708.25396825397
67,"NYC-Bronx Community District 7--Bedford Park, Fordham North & Norwood PUMA",12828,5678,7150,48598.341908325536,48154.66537513209,48950.67692307692,2665,919,1746,69122.19136960601,77375.2339499456,64778.23596792669,8558,4565,3993,46367.42112643141,43828.247535596936,49270.333082895064,1605,194,1411,26415.26479750779,11538.144329896908,28460.7370659107
68,Suffolk County (Central)--Brookhaven Town (West Central) PUMA,31726,17894,13832,73526.21288533065,90076.62233150777,52115.49667437825,13213,6827,6386,88244.42215999395,111490.74263951955,63392.77325399311,17988,10739,7249,63566.83344451857,77544.26855386907,42860.02207200993,525,328,197,44340.723809523806,54682.560975609755,27121.827411167513
69,NYC-Queens Community District 1--Astoria & Long Island City PUMA,46754,23556,23198,69850.59438764598,72785.2564102564,66870.64358996465,34771,16070,18701,74592.02755169538,80554.95332918482,69468.01187102294,11298,7159,4139,57828.52717295096,57013.242072915215,59238.6808407828,685,327,358,27457.810218978102,36249.54128440367,19427.374301675976
70,Jefferson & Lewis Counties PUMA,42793,26827,15966,51704.1322178861,56033.12148208894,44430.31316547664,11499,5892,5607,67960.73223758588,71502.53224711474,64238.904940253255,29652,19707,9945,46200.90280588156,52449.97868777592,33817.741578682755,1642,1228,414,37238.30694275274,39312.62214983713,31085.507246376812
71,Nassau County (West Central)--Hempstead Town (Northwest) PUMA,29286,16808,12478,102567.15836918664,118467.25428367444,81149.55842282416,15578,8068,7510,126891.81538066504,153824.12121963312,97958.41411451399,12600,8020,4580,78732.06349206349,90492.70573566084,58138.10043668122,1108,720,388,31621.931407942237,33879.305555555555,27432.98969072165
72,Nassau County (Central)--Hempstead Town (North Central)--Meadowbrook Corridor PUMA,23288,9074,14214,62446.42390930952,69498.52655940049,57944.469537076126,8767,2722,6045,73899.11828447587,91675.97354886113,65894.3870967742,13591,5647,7944,56595.58899271577,62503.8657694351,52395.68479355489,930,705,225,39987.20430107527,39898.29787234042,40265.77777777778
73,Orange County (Northeast)--Greater Newburgh City PUMA,32961,17057,15904,63900.96659688723,72695.44996189247,54468.90530684104,12043,5598,6445,92932.66627916633,107004.29617720614,80710.32583397983,19177,10584,8593,48674.45168691662,57247.04648526077,38115.58477830792,1741,875,866,30799.36817920735,40061.142857142855,21441.33949191686
74,"NYC-Bronx Community District 11--Pelham Parkway, Morris Park & Laconia PUMA",24871,12813,12058,56463.47392545535,54118.7465854991,58955.0140985238,8020,2754,5266,74184.24688279301,67247.96659404502,77811.76604633497,15081,8877,6204,50754.0879252039,53766.65540159964,46443.55254674404,1770,1182,588,24815.254237288136,26172.58883248731,22086.73469387755
75,"NYC-Queens Community District 12--Jamaica, Hollis & St. Albans PUMA",38612,17200,21412,56117.108411892674,60170.3988372093,52861.14935550159,10859,2587,8272,69283.75264757345,75097.1240819482,67465.66852030948,25086,13145,11941,53618.03077413697,59865.53062000761,46740.60128967423,2667,1468,1199,26014.098237720285,36595.50408719346,13058.715596330276
76,Erie County (Central) PUMA,53699,29875,23824,55170.64749809121,58974.46828451883,50400.7034922767,19835,9944,9891,69546.35139904209,76616.29625905068,62438.522899605705,31847,18249,13598,47311.571576600625,51278.4092279029,41987.93425503751,2017,1682,335,37890.48091224591,38174.85136741974,36462.68656716418
77,"NYC-Staten Island Community District 1--Port Richmond, Stapleton & Mariner's Harbor PUMA",34542,18248,16294,73498.36170459152,83964.07551512495,61777.58438689088,15727,7522,8205,96256.85508997265,113881.69369848445,80099.14198659355,17292,9391,7901,55780.005204718946,66440.99137472047,43108.53056575117,1523,1335,188,39659.22521339462,38659.925093632955,46755.31914893617
78,"NYC-Brooklyn Community District 15--Sheepshead Bay, Gerritsen Beach & Homecrest PUMA",16377,8976,7401,87434.15704952067,103054.1232174688,68490.12025401973,8900,4121,4779,99768.22359550562,128173.33171560301,75274.09290646578,6493,4167,2326,70624.48791005698,86642.74298056155,41927.98366294067,984,688,296,86795.93495934959,51993.023255813954,167689.1891891892
79,"NYC-Bronx Community District 8--Riverdale, Fieldston & Kingsbridge PUMA",22116,11217,10899,95456.20184481824,104537.30676651512,86110.13762730526,12087,4442,7645,136936.3762720278,192612.25799189555,104586.83191628515,7739,5305,2434,47948.56958263341,51017.51555136663,41259.67953985209,2290,1470,820,37067.86026200873,31539.72789115646,46978.04878048781
80,NYC-Brooklyn Community District 5--East New York & Starrett City PUMA,25719,12415,13304,50110.230180022554,54488.13532017721,46024.8654539988,7893,3065,4828,69739.24996832636,73741.23980424144,67198.63297431648,16379,8534,7845,41607.57128029794,48403.9254745723,34214.31612492033,1447,816,631,39283.137525915685,45801.71568627451,30853.407290015846
81,Onondaga County (Central)--Syracuse City (Outer) PUMA,53030,28373,24657,67288.82217612672,73172.23205159834,60518.73707263658,27175,13425,13750,84594.44710211591,96097.20670391062,73363.57090909091,24661,14379,10282,49007.70609464336,53141.785937826,43226.34701419957,1194,569,625,50999.246231155776,38462.214411247805,62412.96
82,"NYC-Manhattan Community District 6--Murray Hill, Gramercy & Stuyvesant Town PUMA",51554,28503,23051,148023.08201109516,166891.07602708487,124692.4484837968,47491,25453,22038,154225.71645153817,178325.02573370526,126391.98747617751,3653,2640,1013,82462.36244182863,80445.45454545454,87718.66732477788,410,410,0,13691.365853658537,13691.365853658537,0.0
83,"Chenango, Delaware & Broome (East) Counties PUMA",33095,18844,14251,48464.738782293396,53238.02961154744,42153.048908848505,6762,3445,3317,70103.84649511978,80626.99564586357,59174.618631293335,23885,13938,9947,44007.72953736655,47694.8938154685,38841.177239368655,2448,1461,987,32178.799019607843,41537.30321697467,18325.93718338399
84,Orange County (Northwest) PUMA,34407,19530,14877,70433.6789025489,76940.03328213005,61892.3667406063,9043,4328,4715,105708.89196063254,126160.21950092421,86936.17815482503,23681,14195,9486,56814.58046535197,63030.885523071505,47512.403542061984,1683,1007,676,72525.25252525252,61463.753723932474,89002.95857988166
85,NYC-Brooklyn Community District 7--Sunset Park & Windsor Terrace PUMA,19094,10077,9017,80075.02985230963,80007.5617743376,80150.42918930908,13155,5942,7213,92392.84834663627,94430.07404914171,90714.60141411341,5470,3999,1471,54965.79524680073,60185.021255313826,40777.02243371856,469,136,333,27423.880597014926,32741.176470588234,25252.252252252252
86,Nassau County (Northeast)--Oyster Bay Town (North) & Glen Cove City PUMA,25832,14962,10870,153940.4355063487,192677.27041839325,100621.16007359706,17540,9909,7631,191373.5535917902,248581.6348773842,117087.76176123705,7788,4629,3159,76926.70775552132,86685.22359040829,62627.19214941437,504,424,80,41253.968253968254,43339.622641509435,30200.0
87,Dutchess County (North & East) PUMA,37729,21019,16710,82686.8355906597,90164.41219848709,73281.0197486535,18678,9053,9625,97637.26469643431,110946.7071688943,85118.78337662338,18299,11401,6898,69613.75976829336,76675.99684238224,57941.30907509423,752,565,187,29468.882978723403,29349.026548672566,29831.01604278075
88,Putnam County PUMA,30991,18011,12980,93740.26975573554,103532.99650213758,80151.91833590138,14964,8049,6915,121490.50387596899,139541.27220772766,100479.56616052061,15057,9647,5410,67828.81052002391,74805.13112884834,55388.78003696858,970,315,655,67858.14432989691,63238.09523809524,70080.0
89,Albany County (Outside Albany City) PUMA,61964,32418,29546,72114.68126654187,79964.90159787772,63501.3852975022,30309,13472,16837,86887.6709888152,99000.2375296912,77195.89119201757,30015,17607,12408,59087.92903548226,68200.49866530357,46157.157479045774,1640,1339,301,37507.01219512195,43140.25392083645,12447.50830564784
90,"NYC-Bronx Community District 10--Co-op City, Pelham Bay & Schuylerville PUMA",27710,14140,13570,63749.018837964635,62973.345968882604,64557.27339719971,10306,3336,6970,86142.20842227829,94627.27817745804,82081.06169296987,16220,9834,6386,50576.97361282368,53853.499288183855,45531.3498277482,1184,970,214,49278.04054054054,46568.24742268041,61560.7476635514
91,NYC-Queens Community District 4--Elmhurst & South Corona PUMA,11191,6699,4492,54229.42543115003,59209.8223615465,46802.07034728406,4549,2400,2149,68236.40360518795,79226.41666666667,55962.77338296882,6105,4018,2087,45311.31859131859,49059.90542558487,38094.345951126015,537,281,256,36961.824953445066,33382.56227758007,40890.625
92,"NYC-Brooklyn Community District 12--Borough Park, Kensington & Ocean Parkway PUMA",15077,10903,4174,71320.9471380248,73608.55727781345,65345.42884523239,6790,4073,2717,86293.61266568484,92644.62312791555,76772.94074346706,7226,6023,1203,60733.336562413504,64124.24871326581,43756.226101413136,1061,807,254,47609.04806786051,48317.47211895911,45358.26771653543
93,Nassau County (Southeast)--Oyster Bay Town (South) PUMA,37758,20145,17613,92633.93267651889,109137.69223132292,73757.63470164084,20116,10104,10012,101433.02545237621,119816.16785431512,82880.96084698362,16950,9678,7272,83641.43303834808,100266.81649101054,61515.40704070407,692,363,329,57114.16184971098,48413.223140495866,66714.28571428571
94,Suffolk County (Northwest)--Huntington Town (South) PUMA,27384,15691,11693,110872.56682734443,121316.0231980116,96858.34687419824,17263,9823,7440,127964.70428083184,138186.1284739896,114469.40188172043,9877,5662,4215,82694.32823731903,94728.64358883786,66528.65954922895,244,206,38,42245.08196721312,47639.80582524272,13000.0
95,Oswego County PUMA,39142,23335,15807,54724.7467170814,60123.13074780373,46755.41089390776,9911,5049,4862,75494.74926848956,83241.64785105962,67449.89304812835,26325,16280,10045,49493.33622032289,56215.520638820635,38598.646092583374,2906,2006,900,31278.56159669649,33647.806580259225,25997.777777777777
96,Rensselaer County--Troy City PUMA,55144,29281,25863,59426.73074133178,62837.94610839794,55564.6962842671,19637,9458,10179,75474.86836074757,81049.6151406217,70294.99263188918,32802,17883,14919,49879.51466374002,52136.07056981491,47174.642402305784,2705,1940,765,58698.63585951941,72701.69587628866,23187.607843137255
97,Saratoga County (Outer) PUMA,44908,26783,18125,79302.89035361183,92451.57749318598,59873.30206896552,17198,9303,7895,121862.43865565764,158262.2541115769,78971.05383153894,25533,15799,9734,54110.197783260875,59205.54148996772,45840.079104170945,2177,1681,496,38561.46072576941,40707.01963117192,31289.91935483871
98,Herkimer (North & Central) & Oneida (Outer) Counties PUMA,37380,21133,16247,53291.51738897806,58140.18975062698,46984.69194312796,9417,3823,5594,67714.79027291069,84281.9513471096,56392.6135144798,26180,16081,10099,48806.48357524828,53006.829799141844,42118.12159619764,1783,1229,554,42968.59226023556,43990.15459723352,40702.34657039711
99,Monroe County (East) PUMA,48541,27350,21191,73335.7098123236,80969.91334552102,63482.68415836912,28877,14802,14075,83103.11701354019,94069.76692338873,71570.0191829485,18769,11749,7020,60992.294741328784,69082.54659971061,47452.071225071224,895,799,96,17045.36312849162,13085.857321652065,50000.0
100,"NYC-Queens Community District 13--Queens Village, Cambria Heights & Rosedale PUMA",27724,14151,13573,66934.97763670466,74983.15313405413,58544.074265085095,12095,5399,6696,72324.11326994626,75653.87479162808,69639.31899641576,14500,8099,6401,61520.70137931035,71975.71675515496,48292.27308233089,1129,653,476,78737.8210806023,106738.13169984685,40325.63025210084
101,Erie County (South) PUMA,60224,33452,26772,63018.70566551541,70316.17332297022,53900.414612281485,26886,12395,14491,75232.99449527635,91824.42759177087,61041.371195914704,31631,19489,12142,53500.940216875846,58493.14228539176,45488.00774172295,1707,1568,139,47004.10076157001,47244.897959183676,44287.76978417266
102,Monroe County (Central)--Greece & Gates Towns PUMA,39617,20541,19076,59725.70512658707,67007.49233240835,51884.69071084085,15373,7576,7797,79972.61432381449,93274.9181626188,67047.35411055534,22857,12251,10606,46967.106794417465,52274.5261611297,40836.501980011315,1387,714,673,45571.08868060562,41085.294117647056,50330.163447251114
103,NYC-Manhattan Community District 7--Upper West Side & West Side PUMA,53446,27646,25800,182586.7978894585,216388.1664616943,146366.92829457365,47229,23895,23334,199748.0586080586,241428.6775476041,157065.34713293906,5367,3528,1839,55098.49822992361,59835.31746031746,46011.22349102773,850,223,627,34022.705882352944,10000.0,42566.666666666664
104,NYC-Manhattan Community District 11--East Harlem PUMA,22014,10075,11939,71427.55882620151,74373.94342431762,68941.18435379848,12305,5056,7249,89581.63998374644,104294.95253164557,79319.46475375914,8493,3803,4690,49715.9072177087,45788.90349723902,52900.213219616206,1216,1216,0,39364.30921052631,39364.30921052631,0.0
105,"NYC-Queens Community District 7--Flushing, Murray Hill & Whitestone PUMA",26456,15331,11125,73865.03076806774,85497.02432978932,57835.35946067416,12962,6546,6416,88731.6775189014,111221.76596394744,65785.89837905236,12438,8006,4432,60309.169480623896,66390.85685735698,49323.16110108303,1056,779,277,51049.05303030303,65689.34531450577,9876.534296028882
106,NYC-Brooklyn Community District 1--Greenpoint & Williamsburg PUMA,47870,29011,18859,107914.94109045331,111995.24456240736,101638.16692295455,38375,22076,16299,119374.11413680782,126648.92371806486,109520.82888520768,7661,5384,2277,64451.23352042814,69142.10624071323,53359.59595959596,1834,1551,283,49697.764449291164,52180.077369439074,36093.286219081274
107,Onondaga County (North) PUMA,42780,23273,19507,73187.45021037868,78479.2729772698,66873.99395088943,19489,9867,9622,92516.81358715173,104427.4277896017,80302.925587196,22678,12949,9729,57301.531881118266,59641.917522588614,54186.55051906671,613,457,156,46353.6704730832,51990.15317286652,29841.666666666668
108,NYC-Brooklyn Community District 14--Flatbush & Midwood PUMA,23176,12281,10895,66241.95245081118,71953.94186141193,59803.31620009179,12729,5653,7076,78128.49634692435,89665.25738545904,68911.80469191633,9206,5576,3630,54203.134912013906,60575.261836441896,44414.986225895314,1241,1052,189,33627.55842062853,37092.20532319391,14342.857142857143
109,"Rockland County (South)--Orangetown, Clarkstown (South) & Ramapo (Southeast) Towns PUMA",27086,16428,10658,107560.86428413203,118182.56817628439,91188.81028335523,16677,8952,7725,135257.99724171014,159541.79289544237,107117.0860841424,10115,7182,2933,62882.44686109738,68455.17961570593,49236.566655301736,294,294,0,73605.44217687075,73605.44217687075,0.0
110,NYC-Brooklyn Community District 13--Brighton Beach & Coney Island PUMA,7267,3533,3734,65256.93133342507,70655.99773563544,60148.494911622925,3037,1698,1339,77243.08198880474,75159.71731448763,79885.01867064973,3909,1786,2123,58446.1192120747,67050.63829787234,51207.461139896375,321,49,272,34794.392523364484,46000.0,32775.73529411765
111,"NYC-Bronx Community District 4--Concourse, Highbridge & Mount Eden PUMA",15522,8695,6827,47709.73650302796,54926.51178838413,38518.31111762121,4316,1339,2977,56097.81047265987,77435.56385362211,46500.48034934498,9206,5963,3243,44622.93938735607,50438.2693275197,33930.12025901943,2000,1393,607,43816.8,52502.79971284996,23883.3607907743
112,Erie County (Northeast) PUMA,43761,24572,19189,74601.41221635703,84546.58025394758,61866.372921986556,20774,10052,10722,91209.63030711467,109185.68046159968,74356.87371759,22282,13815,8467,60171.26559554798,68826.39956568947,46049.300814928545,705,705,0,41287.09219858156,41287.09219858156,0.0
113,NYC-Brooklyn Community District 8--Crown Heights North & Prospect Heights PUMA,38974,16547,22427,76044.08349155847,79383.93243488246,73579.88941900388,26558,10594,15964,90481.9387755102,100000.09722484426,84165.51616136306,10363,5282,5081,46767.14464923285,43152.76410450587,50524.50698681362,2053,671,1382,37055.460301997075,39093.88971684054,36065.74529667149
114,NYC-Queens Community District 3--Jackson Heights & North Corona PUMA,17061,10195,6866,62536.66314987398,63490.39823442864,61120.50684532479,7488,3655,3833,82284.8157051282,89887.68809849521,75035.01174015131,8774,5971,2803,48601.12947344426,50763.508625020935,43994.791295041025,799,569,230,30491.864831038798,27480.140597539543,37942.608695652176
115,Fulton & Montgomery Counties PUMA,32630,19296,13334,50303.29788538155,55015.32701077944,43484.390280485975,7880,3822,4058,65795.79187817259,70503.61067503925,61361.76441596846,21693,13356,8337,47951.15290646753,55297.958969751424,36181.45855823438,3057,2118,939,27059.669610729474,25283.951841359773,31064.96272630458
116,Niagara County (Southwest)--Greater Niagara Falls & North Tonawanda Area PUMA,35283,16998,18285,58503.9758523935,68651.69961171903,49070.50533223954,9540,4247,5293,83854.98113207547,119264.13939251236,55443.36293217457,23814,11335,12479,48202.08952716889,53550.576973974414,43343.91938456607,1929,1416,513,60308.2944530845,37733.75706214689,122619.29824561403
117,"Steuben (North & West), Schuyler & Chemung (North) Counties PUMA",29517,17034,12483,49163.26591455771,53438.242338851705,43329.73644156052,6550,2638,3912,71776.2854961832,86058.23351023503,62145.46267893661,21577,13312,8265,43124.77869954118,48211.808894230766,34931.36721113128,1390,1084,306,36341.07913669065,38237.822878228784,29621.895424836603
118,NYC-Brooklyn Community District 4--Bushwick PUMA,31130,17198,13932,64862.85576614198,73462.81835097104,54246.85256962389,18745,9078,9667,73061.40464123766,83606.53007270324,63158.782455777386,10463,7048,3415,56251.82356876613,66869.66940976163,34338.3308931186,1922,1072,850,31780.35379812695,30910.485074626864,32877.41176470588
119,"NYC-Manhattan Community District 4 & 5--Chelsea, Clinton & Midtown Business District PUMA",54172,30004,24168,173558.74492357674,208045.29129449406,130744.51381992718,47061,25943,21118,187017.18769256922,223029.72131210731,142776.57969504688,7030,3980,3050,85290.67709815079,114300.46733668342,47435.27868852459,81,81,0,15000.0,15000.0,0.0
120,"NYC-Brooklyn Community District 6--Park Slope, Carroll Gardens & Red Hook PUMA",42677,19329,23348,134837.53567495372,180943.95778364115,96667.62677745418,37266,15756,21510,145065.61611120056,206674.66806296015,99937.20037192004,4819,3425,1394,67690.44615065366,68723.99708029197,65151.05451936872,592,148,444,37577.7027027027,38648.64864864865,37220.72072072072
121,NYC-Brooklyn Community District 3--Bedford-Stuyvesant PUMA,35734,17710,18024,72720.94783679409,82331.77809147374,63277.5499334221,20999,9410,11589,90889.30853850183,113381.05951115834,72626.52687893693,13669,7718,5951,48612.69002853172,48429.28478880539,48850.5528482608,1066,582,484,23957.69230769231,29901.71821305842,16810.12396694215
122,NYC-Queens Community District 10--Howard Beach & Ozone Park PUMA,18400,10763,7637,62587.74456521739,61085.357242404534,64705.09362315045,7377,3162,4215,72706.15426325065,70895.60404807085,74064.38908659549,10100,6745,3355,55933.89108910891,57124.67012601927,53539.91058122206,923,856,67,54527.51895991332,56055.957943925234,35000.0
123,Suffolk County (Northwest)--Huntington Town (North) PUMA,30701,17130,13571,122082.09537148627,136221.40980735552,104234.74025495542,19705,10595,9110,153296.81603653895,172065.05427088248,131469.21075740943,9935,5560,4375,70780.9411172622,88009.62230215827,48885.74857142857,1061,975,86,22733.270499528746,21651.28205128205,35000.0
124,Orange County (Southeast) PUMA,33580,20686,12894,77527.66795711733,89936.25447162332,57620.42267721421,16146,8173,7973,98865.63173541434,130678.60761042457,66254.63815376897,15856,10998,4858,58125.86402623612,64782.52409529005,43055.88719637711,1578,1515,63,54151.394169835236,52743.828382838285,88000.0
125,Nassau County (East Central)--Oyster Bay Town (Central) PUMA,25022,14507,10515,108453.74310606666,125088.03749913834,85504.27009034713,17147,9217,7930,122883.75750860208,145715.31843332972,96346.74653215636,7429,4993,2436,77355.6023690941,90214.11375926297,50999.87684729064,446,297,149,71674.88789237668,71228.95622895623,72563.75838926174
126,Suffolk County (Northwest)--Smithtown Town PUMA,39157,22316,16841,114571.16888423526,135738.7659078688,86521.99750608634,24769,13013,11756,131271.03233881062,161017.73226773227,98343.69258251105,14010,9103,4907,86732.81655960028,100740.00329561683,60748.01508049725,378,200,178,52074.86772486773,83931.5,16280.898876404495
127,"NYC-Brooklyn Community District 17--East Flatbush, Farragut & Rugby PUMA",18373,8900,9473,56910.04898492353,57303.12359550562,56540.750554206694,9244,2774,6470,64301.92016443098,66549.56741167989,63338.245749613605,8310,5648,2662,50639.925391095065,54222.68059490085,43038.347107438014,819,478,341,37098.4126984127,40041.00418410042,32973.60703812317
128,"NYC-Bronx Community District 9--Castle Hill, Clason Point & Parkchester PUMA",26572,13293,13279,55126.25244618396,59660.27984653577,50587.44483771369,7725,3232,4493,55397.82524271845,60867.29579207921,51463.40974849767,16811,8943,7868,57304.489917316045,60695.9633232696,53449.641586171834,2036,1118,918,36110.41257367387,47886.404293381034,21768.84531590414
129,NYC-Queens Community District 9--Richmond Hill & Woodhaven PUMA,17218,9407,7811,60336.08665350215,62034.61783778037,58290.49929586481,7553,3822,3731,74638.03654177148,79662.32339089482,69491.20611096222,9013,5270,3743,49973.58815044935,50481.12903225807,49258.99011488111,652,315,337,37904.447852760735,41443.49206349206,34596.43916913946
130,Westchester County (Southwest)--Yonkers City PUMA,39310,21582,17728,74109.90613075554,75130.22750440182,72867.77075812274,17977,8920,9057,94739.47043444401,100231.32399103139,89330.68896985757,18743,10642,8101,58702.48359387505,59887.05694418342,57146.351067769414,2590,2020,570,42420.19305019305,44593.61386138614,34717.89473684211
131,Broome (Outer West) & Tioga Counties PUMA,32943,18977,13966,56634.41945178035,63323.661274174,47545.07804668481,9811,4646,5165,84642.96401997757,100969.42961687472,69957.04743465634,21579,13163,8416,45263.416284350526,52589.702195548125,33804.77780418251,1553,1168,385,37692.401802962006,34547.00342465754,47234.805194805194
132,NYC-Brooklyn Community District 10--Bay Ridge & Dyker Heights PUMA,22210,10863,11347,93109.79063484917,110988.2030746571,75993.97197497135,15588,7182,8406,104748.13253784963,130611.11111111111,82651.0694741851,6433,3596,2837,66889.09684439609,73876.76585094549,58031.97391610857,189,85,104,25698.4126984127,23000.0,27903.846153846152
133,"NYC-Queens Community District 5--Ridgewood, Glendale & Middle Village PUMA",35381,19034,16347,69373.79243096577,71323.21529893874,67103.93772557656,15682,7906,7776,85699.70348169876,91895.30483177333,79400.5234053498,17893,9604,8289,57643.905437880734,58309.12119950021,56873.157196284235,1806,1524,282,43825.58139534884,46614.82939632546,28751.77304964539
134,NYC-Manhattan Community District 10--Central Harlem PUMA,35726,16873,18853,85511.62850585008,100547.88182303088,72054.52872221927,23291,11140,12151,107342.74354901035,130335.14452423698,86263.37996872685,11201,5511,5690,46492.40246406571,43035.909998185445,49840.15817223198,1234,222,1012,27639.546191247973,33513.51351351351,26350.988142292492
135,"NYC-Queens Community District 11--Bayside, Douglaston & Little Neck PUMA",17980,10315,7665,79921.70522803115,87940.0019389239,69131.26418786692,11011,6087,4924,86564.22304967759,97928.17808444226,72516.2144597888,6756,4066,2690,69987.95145056247,74313.64977865224,63449.553903345724,213,162,51,51619.718309859156,54648.148148148146,42000.0
136,Erie County (Northwest) PUMA,37382,21750,15632,62279.72232625328,67095.42298850574,55579.268807574204,17114,8028,9086,74400.84725955359,88887.86372695565,61600.740699977985,19294,12980,6314,52515.16948274075,55264.78274268105,46862.65441875198,974,742,232,42727.720739219716,38270.61994609165,56982.75862068965
137,NYC-Queens Community District 2--Sunnyside & Woodside PUMA,22730,12845,9885,83091.07963044435,92891.36395484624,70356.16287303995,16485,9222,7263,89498.28146800121,99435.43374539145,76880.84813437973,5729,3308,2421,67351.90609181358,79070.13301088271,51340.38413878562,516,315,201,53143.410852713176,46450.793650793654,63631.840796019904
138,Suffolk County (Southwest)--Babylon Town (Southeast) PUMA,30161,16987,13174,69966.2577500746,75925.5548360511,62282.13906178837,10077,4765,5312,88309.55641559989,103835.59286463799,74382.30421686747,19666,12004,7662,60977.46872775348,65257.98067310896,54271.22161315583,418,218,200,50655.5023923445,53275.22935779816,47800.0
139,"NYC-Staten Island Community District 3--Tottenville, Great Kills & Annadale PUMA",43641,24059,19582,88181.55381407392,98467.03104867201,75544.52507404759,19236,9100,10136,107183.16385943023,129033.28571428571,87566.34175217048,23702,14410,9292,74201.28470171294,82045.69049271339,62036.20856650882,703,549,154,39597.43954480797,22836.06557377049,99350.64935064936
140,Nassau County (West Central)--Hempstead Town (West Central) PUMA,30630,17902,12728,83922.8109696376,79228.83923583956,90524.90729101194,15702,8031,7671,101846.08139090562,94064.08043830158,109993.29161778126,14380,9323,5057,64366.5528511822,66196.34774214309,60993.17381846945,548,548,0,83535.58394160584,83535.58394160584,0.0
141,Nassau County (Central)--Hempstead Town (Northeast) PUMA,33153,16499,16654,89205.55937622538,106217.10891569186,72352.33757655819,16005,6583,9422,108934.26991565136,144781.35500531673,83888.4875822543,16538,9423,7115,72189.79320353126,82824.0687679083,58105.91707659874,610,493,117,32892.0,38395.983772819476,9700.0
142,Nassau County (Southwest)--Hempstead Town (Southwest) & Long Beach City PUMA,26663,16896,9767,102537.27712560477,121809.44779829546,69198.21746698066,16466,10844,5622,128337.62783918377,154841.9135005533,77214.81145499823,9878,5733,4145,61755.420125531484,64235.604395604394,58325.04704463208,319,319,0,33617.55485893417,33617.55485893417,0.0
143,NYC-Brooklyn Community District 11--Bensonhurst & Bath Beach PUMA,18311,10176,8135,63009.87657692098,67640.11890723271,57217.9471419791,9140,4883,4257,75037.94857768052,81379.40815072702,67763.96523373267,8517,4976,3541,52624.93835857696,56382.676848874595,47344.36599830556,654,317,337,30153.516819571865,32712.933753943216,27745.9940652819
144,Nassau County (South Central)--Hempstead Town (Southeast) PUMA,28337,15791,12546,102955.28778628648,115203.1308973466,87539.56241032999,16272,8389,7883,125344.48684857423,145366.08534986293,104037.72675377394,11634,6971,4663,73477.6087330239,82727.95151341271,59648.71327471585,431,431,0,53364.269141531324,53364.269141531324,0.0
145,Nassau County (West Central)--North Hempstead Town (South) PUMA,26423,14498,11925,95136.83608977028,112924.83032142365,73510.81174004193,15773,8495,7278,116961.97616179548,141339.33137139495,88508.33058532565,10483,6003,4480,63275.242774015074,72714.73763118441,50626.74107142857,167,0,167,33802.39520958084,0.0,33802.39520958084
146,Capital Region,348794,188581,160213,521201.1345636581,565348.6383339358,465928.2914799076,146060,69450,76610,697912.9564795592,791684.028146548,604368.7290989121,189110,110059,79051,399770.8891218046,437744.5024194857,345448.20116172417,13624,9072,4552,306792.25525173766,335207.04869572166,224736.3576551959
147,Central NY,236214,130841,105373,362020.8779098456,393461.1428335721,322703.43915187643,90132,43769,46363,477464.0349942995,550467.6644718463,409435.8982885155,135194,79726,55468,295362.00356514205,319465.16251530277,259551.10167252863,10888,7346,3542,246599.08138152794,235522.6968094774,219865.92290367914
148,Finger Lakes,375857,205265,170592,601576.3511731642,653567.6896254314,539298.5013144214,155609,74928,80681,785990.385253483,874633.8937960532,704283.2237651561,206077,120784,85293,485843.1477866039,536818.9277647228,410742.1481662126,14171,9553,4618,374935.24724155053,383949.658907292,386949.98410302994
149,Long Island,761376,425101,336275,2417214.549391257,2788707.2703810763,1931136.6176149012,396351,200952,195399,2868801.3506756034,3422265.1433729045,2267769.2086294703,347576,211325,136251,1800724.9023994626,2059845.2974687028,1387347.292549638,17449,12824,4625,1203809.6669477662,1295898.0811544305,793562.9166316282
150,Mid-Hudson,574002,327527,246475,1655185.5994039623,1875260.8376166578,1347768.9686741934,288621,148997,139624,2101636.3898234456,2497499.3076565275,1652446.9182682557,266208,164506,101702,1097980.0614241702,1213722.5096695428,907107.16062885,19173,14024,5149,797144.4029446496,808354.6320415051,556213.1452001914
151,Mohawk Valley,147216,84104,63112,214019.1576176546,231686.7563615129,190403.33523198668,42666,20678,21988,290421.18592811853,328920.7861770044,256146.94696459867,95859,57139,38720,186119.81405409027,205813.2223854316,156749.8727724042,8691,6287,2404,134114.96989996376,135605.90210598736,128498.60726819292
152,New York City,1582794,812363,770431,4415192.107390668,4917957.387537854,3882630.832868847,963523,456366,507157,5187702.335549236,5945231.054506702,4509100.61435214,556987,318946,238041,3168831.8515912932,3428057.8930218467,2796947.456374581,62284,37051,25233,2153226.2352422522,2399744.779776716,1865974.4640422554
153,North Country,126115,74198,51917,162815.9104143046,174119.6662151664,146404.49991484318,36609,16246,20363,225519.35916199326,253979.9295017789,204144.1164216044,84617,54286,30331,139637.8428677587,155954.45314604737,110306.40509696087,4889,3666,1223,92101.26672632279,89266.84345626844,111478.92799308199
154,Southern Tier,183583,99565,84018,339509.58645978646,371011.8293493336,301849.9510287666,61764,29705,32059,471189.284147789,526058.1348343545,417426.92770995095,114040,64847,49193,276823.7663469349,322190.4262707637,216541.0109921145,7779,5013,2766,290057.48575960094,213261.7620387531,435971.27528364473
155,Western NY,442275,240630,201645,645300.4579047264,710047.9304250639,569552.5739691476,175913,82180,93733,817658.0445021308,970173.7998012858,690358.8001105959,249996,145834,104162,527870.435226338,581312.1194717976,453113.0624048863,16366,12616,3750,445743.6472108107,400905.0459425035,506479.9339938238
